factor	bdnf	6
facility	bd-live	1
source	bd	3
source	bdc boiler	1
source	bdo office	1
source	bd disc	1
source	bdc	1
subject	bdsm	1
product	bdu	1
product	bdv oil tester	1
work	bdag	1
word	bd	1
institution	bda	4
institution	bdb	1
client	bdo	1
feature	bd live	3
strategy	bda-based routing algorithm	1
strategy	bds movement	1
approach	bdd	1
approach	bdi	1
alternative	bdd	1
agency	bda	4
agency	bdapsn	1
agency	bdl	1
theme	bdsm	1
course	bds	3
writer	bd gallof	1
action	bdsm orgy	1
action	bdcp conservation measure	1
field	bds	1
practice	bdd	2
scholar	bdsm training california pragmatism scholar	1
feature	bd-live functionality	1
feature	bd-live interactivity	1
feature	bdsm piece	1
development	bda driver	1
development	bdi register	1
disease	bd limit basicdaily activity	1
firm	bdo	3
firm	bd medical	1
firm	bdo stoy hayward	1
job	bdf	1
advantage	bd live	1
manufacturer	bd	2
instrument	bdi	1
instrument	bdsm flogging instrument	1
feature	bd-live facility	1
compound	bdnf	3
class	bdirectory	1
study	bdf	1
unit	bd players	1
style	bdsm	1
feature	bd-live tm interactivity	1
feature	bd wise	1
feature	bd-live	1
format	bd-rom	2
format	bd-r	1
format	bd-re	1
advanced feature	bd-live internet connectivity	1
vendor	bds	2
vendor	bdl industry	1
behavior	bdd-related compulsive and safety behavior	1
environment	bdi development environment	1
award	bda silver	2
award	bdb award	1
award	bde service commendations	1
award	bde achievement awards	1
chemical	bdo	2
disorder	bdd	2
module	bde	1
retailer	bdl	1
protein	bdnf	4
occasion	bday party	1
competitor	bd	2
competitor	bd's handylab	1
issue	bdd	1
stakeholder	bda	1
good	bdu acu cp uniform	1
weapon	bds staffs	1
driver	bde	1
supplier	bd biosciences clontech	1
top brand	bdi	2
top brand	bd	1
arrangement	bdsm	1
molecule	bdnf	2
molecule	bdca- two 	1
organism	bdelloid rotifers	1
association	bdi	1
station	bdr	1
standard feature	bd-live	1
sponsor	bdr racing	1
target	bdnf	1
talent	bdsm dominatrix in south dakota	1
talent	bdsm dominatrix in texas	1
talent	bdsm dominatrix in arkansas	1
talent	bdsm dominatrix in wisconsin	1
government agency	bdc	1
gene	bdnf	7
gene	bdl	1
enhancement	bd live	1
page	bd npcs	1
creature	bdelloid rotifers	1
content	bd-j	2
programme	bdp	1
issue	bdsm	1
genus	bdellovibrio	3
item	bdu pant	4
item	bdu coat	3
online service	bd-live	4
conference	bdsm bootcamp	1
coating	bd matrigel	1
heavyweight	bd wong	1
map	bdr's deutsche rad-tourenkarte	3
quality brand	bdi	1
branch	bdds branch	1
software tool	bd development software tool	1
construction	bda block	2
luxury item	bd player	1
scale	bdi	1
mod	bd suspension	1
obligation	bday gift	1
growth factor	bdnf	17
gallery	bd&sm	1
gallery	bd sm asian boys different kinds of sex	1
architecture	bdi	2
file format	bdm	1
research	bdo inflation index	1
protection	bd copy protection of blu-ray discs	1
area	bdsm	1
opening	bdg	1
soil property	bd	1
antigen	bdca- two 	1
antigen	bdca- four 	1
exam	bds	1
pharmaceutical company	bd dickenson www.bd.com	1
area	bd&g structure	1
mental disorder	bdd	1
enhanced feature	bd-java	1
office function	bdt	1
fossil	bdelloid rotifers	1
latest feature	bd-live	1
frill	bd-live	2
medium format	bd	1
questionnaire	bdi	1
disc	bd java-enabled disc	1
service	bdb	1
international firm	bdo	1
simulator	bda's analog fastspice rf	2
local bank	bdo	8
notation	bdl	1
notation	bd.	1
os	bdb supportother real-time os	1
recording medium	bd-rom	5
recording medium	bd-rom for distribution of movie	2
recording medium	bd-r	1
development environment	bdi development environment	1
commercial system	bdi system	1
severe disease	bd	1
online feature	bd-live	1
timer	bdp	1
audio source	bd player	1
liquid fuel	bdf	1
big manufacturer	bd	1
disk	bd	1
disk	bd-rom	1
interactive technology	bd live	2
fetish	bdsm	2
chemical company	bdh	1
topic	bdsm	5
national project	bd compatible integrated pickup	1
anxiety disorder	bdd	1
normal feature	bd live	1
inflammatory disorder	bd	1
trade journal	bd online	1
large construction project	bdci building	1
popular video format	bd-rom	1
national firm	bdo seidman	1
industry luminary	bdale garbee	1
professional service firm	bdo	1
uniform item	bdus	1
clinical measure	bdi	2
classical approach	bdi-based representation	1
subculture	bdsm	1
police agency	bdr	1
degree course	bds	1
good source	bd	1
technical standard	bd	1
professional firm	bdo canada	1
chord	bdf	1
notable brand	bdi entertainment	1
national and international brand	bdi usa known for quality functional entertainment	1
accounting firm	bdo seidman	1
accounting firm	bdo seidman llp	1
accounting firm	bdo	1
neurotrophic factor	bdnf	34
non-financial service	bds	1
filtration system	bd only	1
company	bd	8
company	bd biosciences	5
company	bdf	2
company	bd medical	2
company	bdi	2
third-party provider	bd metrics	1
logic circuit	bdd logic circuit	2
agile practice	bdd	1
undergraduate degree	bdes	1
trophic factor	bdnf	17
medical device company	bd medical systems	1
company	bd diagnostics	1
company	bdo stoy hayward	1
company	bdf nivea	1
company	bd diesel performance	1
company	bde	1
expensive part	bd reader	1
analog system	bd lsr	1
analog system	bd facscalibur	1
analog system	bd facsvantage se cytometers	1
self-report measure	bdi	1
survival factor	bdnf	1
top feature	bd-live support	1
auditor	bdo seidman	2
modern accessory	bdc reticles	2
checker	bdd-based model checker	1
design code	bd	1
diversified company	bd	1
company	bdh	1
company	bdo	1
company	bdo seidman	1
company	bdo seidman llp	1
company	bd diesel	1
company	bd founder group	1
grammar	bdf	1
standard group	bda	2
peptide growth factor	bdnf	1
procurement method	bdp	1
activity	bdsm type activity	1
quality test	bdv test	2
HD video	bdav	1
extracellular factor	bdnf	1
medical course	bds	1
public sector undertaking	bdl	1
source device	bd player	2
source device	bdp player	1
commercially available tool	bdc meta man	1
lexicon	bdag	2
blu-ray player	bd-live blu-ray player	1
implicit method	bdf	1
interactive format	bd-live	1
non-enveloped virus	bdv	1
type activity	bdsm type activity	1
catecholamines	bdnf introduction catecholamines	1
grammarian	bdf	1
model checker	bdd-based model checker	1
tool company	bd	1
creation tool	bd	1
database engine	bde	1
molecular assay	bd geneohm mrsa assay	1
schedulers	bdf scheduler	1
biotech and pharmaceutical company	bd biosciences	1
calibration disc	bd disc from spears & munsil	1
congeners	bde- ninety-nine 	1
disc format	bd	1
standard work	bdag	1
disk format	bd media  one hundred b 	1
business representative	bdi president	1
flexible pipe	bdi's corrugated pipe	1
insitutions	bda	1
supportive institution	bdc	1
crowd	bday party	1
innovative new technology	bd-live	1
accountancy firm	bdo stoy hayward	1
verification system	bdd-based verification system	1
information	bdr	1
high profile firm	bdo	2
best part	bd diesel performance product	1
polypeptide growth factor	bdnf	1
commercial name	bde- fourty-seven 	1
commercial name	bde- ninety-nine 	1
microsoft software product	bds c compiler	1
strategic ally	bdr	1
medium-sized firm	bdo	1
Neurotrophins	bdnf	38
nts	bdnf	1
utah artist	bdac's own sculpting instructor	1
agile development technique	bdd	1
canadian drug	bdith	1
cleaning company	bd	1
consultancy company	bdo compandina	1
Intranasal corticosteroids	bdp	1
investment agency	bdc	1
mid-tier firm	bdo	1
event	bdo world championship	1
phosphate ester	bdp	1
self-report instrument	bdi	1
standardization group	bda	1
diffusible factor	bdnf	1
event	bd party	1
kink	bdsm	1
popular porn category	bdsm	3
rapid diagnostic method	bd directigen flu a kit	1
safety behavior	bdd-related compulsive and safety behavior	1
adult site	bdsm adult site	1
embedded database	bdb xml	1
key molecule	bdnf	1
well renowned name	bd power	1
education item	bdsm women's prison severe flogging pre-school student	1
sexual fetish	bdsm	1
simple code	bd-c- two thousand and four  for board of directors-correspondence- two thousand and four 	1
american restaurant chain	bd's mongolian barbeque	1
chartered accounting firm	bdo dunwoody	1
large regional firm	bdo seidman llp	1
normal cell line	bdsmc bladder cell	2
optical disc apparatus	bd-re recorder	2
protein growth factor	bdnf	1
screening system	bd focalpoint slide profiler	1
STP security feature	bdpu filter	1
exotic category	bdsm	1
organic farm	bd paris creek	1
popular fetish	bdsm	1
rewritable optical disc	bd-re disc	1
organization	bdc	3
organization	bdo	2
stimulatory agent	bdnf	1
SZ associated gene	bdnf	1
transactional table	bdb	14
window apis	bda for hardware support	1
crown financial institution	bdc	1
depression screen	bdi	1
organization	bdpa	1
organization	bdp	1
equal affinity neurotrophins	bdnf	1
good and comprehensive database	bdh	1
insertion point	bdl	1
institutional team	bdf vi	1
institutional team	bdf xi	1
light general mountaineering axe	bd raven pro	2
light general mountaineering axe	bd r aven ultra	1
nerve growth factor	bdnf	5
PBDEs	bde- fourty-seven 	1
PBDEs	bde- ninety-nine 	1
philippine bank	bdo	6
pirated movie release type	bdrip	1
organization	bd	1
reputable regional and international bank	bdo jawad habib	1
self-rating scale	bdi	1
solventogenic gene	bdh b	2
symbolic model checker	bdd-based smv	1
vendavo customer	bd diagnostics	1
technique	bdd	2
technique	bdd variable ordering	1
big audit firm	bdo	1
big listed bank	bdo	1
big, global company	bd biosciences	1
central and peripheral growth factor	bdnf	1
claypan soil property	bd	1
commercial ROM disk	bd	2
dedicated in-house system	bds	1
depression rating scale	bdi	1
domestica bank	bdo	2
fantastic home entertainment system feature	bd wise	1
fetish activity	bdsm	1
formal scale	bdi	1
great how-to and informational article	bdsm glossary	1
Includinga depression screen	bdi	1
multi-channel music	bd music	1
neurotrophic and growth factor	bdnf	1
neurotrophin	bdnf	2
neu-rotrophinsand matrix molecule	bdnf	1
neutrophic factor	bdnf	2
next-generation optical disk	bd	2
non-conventional activity	bdsm	1
on-chip debugging standard	bdm	2
pdc-specific marker	bdca- four 	1
pdc-specific marker	bdca- two 	1
pragmatism scholar	bdsm training california pragmatism scholar	1
primal method	bddc	1
pristine source	bd	1
regard topic	bdsm	1
rich interactive feature	bd-live	1
second-tier accounting firm	bdo seidman	1
second-tier firm	bdo	1
sophisticated molecular test	bdna	1
sport good manufacturer	bdm	1
top name brand exhaust manifold	bd diesel performance	1
versatily tool	bd vipers	1
well-known accountancy practice	bdo stoy hayward	1
well-recognized accounting firm	bdo canada	1
AFAIK embedded sub	bdmv	1
alternate lifestyle	bdsm	1
ancient asexual animal	bdelloid rotifers	1
ancient asexual animal group	bdelloid rotifers	1
asexual species	bdelloid rotifers	1
BD innovation	bd q-syte luer access split-septum device	1
BD innovation	bd nexiva closed iv catheter system	1
BDE tool	bde data dictionary	1
best quality route	bd gray	4
blu-ray disc feature	bd-live for added content	1
name	bdo stoy hayward	1
name	bd flexset template	1
commercial molecular diagnostic test	bd geneohm c. difficile pcr assay	1
commercial molecular diagnostic test	bd geneohm c	1
custom broker	bdp international	1
datum migration tool	bdc	1
dendritic cell marker	bdca- two 	1
depression questionnaire	bdi	1
diesel power part manufacturer	bd power	1
DPSUs	bdl	1
file-based solution	bde	1
fortransactional table	bdb	1
gas -logistic company	bdp	1
hardcore sex activity	bdsm	1
high aspect ratio MEMS technology	bdrie technology	1
high profile private client	bdo simpson xavier	1
homologous neurotrophins	bdnf	1
jadex active component type	bdi agent	1
latest blu-ray disc feature	bd-live for added content	4
factor	bdd	1
case	bdelloid rotifers	2
case	bdsm	1
MSU site	bdj	1
multi-track high definition video	bdav	1
mysql storage engine table	bdb	1
nationwide, mid-tier accounting firm	bdo	1
neuroprotective gene	bdnf	1
neurotrophic and neuroendocrine factor	bdnf	1
next-generation standard	bd	1
next-generation video content standard	bd standard	1
nonoverlapping domain decomposition algorithm	bddc	1
othertrophic factor	bdnf	1
plasma neurotrophic factor	bdnf	1
real-time os	bdb supportother real-time os	1
sexual lifestyle	bdsm	1
Sexual roleplays	bdsm	1
sexual space	bdsm club	1
sharp container mail-back service	bd sharps disposal by mail	1
sheath fluid	bd facsflow solution	2
standard outside cabin	bd	1
case	bdo seidman	1
synthetic liquid fuel	bdf	1
technical standard optical disc	bd	1
thru-material fitting	bd's	2
UK credit card	bd mc	1
year international player	bdf	1
abbreiviations	bd-re	1
activity-dependent gene	bdnf	1
aforementioned, neurotrophins	bdnf	1
application-independent agent architecture	bdi-based architecture	1
Asexual taxa	bdelloid rotifers	1
assumed thata dithiol molecule	bdt	1
audit partnership	bdo seidman	1
auto-injecting device	bd's inject-ease	2
axon-derived neurotrophins	bdnf	1
bayesianscoring function	bdeuproducethe best score from the probabilistic sense of anticipating the next datum	1
belay beiners	bd pearabiner	1
bitmap font format	bdf of pcf	1
bombardier program	bd one hundred  continental jet 	1
business development agency	bdc in place	1
camouflage pattern	bdu uniform	1
certainneurotrophic factor	bdnf	1
chiral diphosphines	bdpp  sixty-seven 	1
clinical governance package	bda's clinical governance kit	1
clonal population	bdelloid rotifer	1
communication distribution frame	bdf	1
data-recordable optical disk	bd-r	1
datum conversion program	bde datapump	1
desiccation-tolerant invertebrate	bdelloid rotifers	1
detection kit	bd probe-tech	1
dynamic application program	bdt sna manager	1
ecsrelease soluble factor	bdnf	1
floor-less shelter	bd betamid	1
generalized software package	bdam	1
generic short-rate model	bdt	1
german industrial association	bdi	2
good CNS target	bdnf receptor	1
good Greek lexicon	bdag	1
good quality aquarium sand	bd aquarium sand	2
hdcp-required device	bd player	1
heavy kink	bdsm	1
high density optical disc	bd in the related art	2
high-density and large-capacity disk	bd	1
high-density disk	bd	1
high-end blu-ray feature	bd-live	1
home cinema system	bdv	1
image duration	bd one 	1
group	bdsm adherent	1
group	bdpa	1
group	bdelloid rotifers	1
group	bda	1
intermediate and basic chemical	bdo	2
IUPAC number	bde- ninety-nine 	2
kinky interest	bdsm toy making	1
large capacity optical disc	bd	1
large international accounting organization	bdo binder	1
large-molecule neurotrophins	bdnf	1
local and national survey	bdbc residents survey	2
low-priority task	bdcs relatively low-priority task	1
meas urement	bdr	1
medieval cultural and historical landmark	bdin fortress	1
middle-tier firm	bdo	1
middleweight firm	bdo simpson xavier	1
multi-delta-layer sample	bdelta-doped si	1
national communication platform	bdaa's website	1
Neurotoxins PBDEs	bde- two hundred and nine 	1
neurotrophic and neuronal repair gene	bdnf	1
neurtrophic factor	bdnf	2
new-standard optical disc	bd	1
Non-mainstream art	bdsm art	1
novel heuristic	bdd bounding	1
odd-shaped carabiners	bd super lock	1
pen needle	bd autoshield pen needle	1
practical reasoning agent architecture	bdi	1
predatory bacterium	bdellovibrio bacteriovorus	1
prevalent PBDE congeners	bde- ninety-nine 	1
professional psychological organ	bdptoofferthe professional psychologist assistance in meeting	1
radio monitoring service	bds	1
rapid sequential recruitment ofendocytic protein	bdpsand phosphatase	1
recruitmrnt firm	bdo	1
Regular MacConkey Agar	bd macconkey ii agar	1
resident dictionary application	bdicty dictionary reader	1
responsible, solvent manufacturer	bd	2
method	bdd	1
sexual culture	bdsm	1
single-use lancet	bd genie lancet	1
small, localized system	bdt	1
spurious site	bdj	1
staff training system	bdm's sophisticated staff group trainer	2
straight gate	bd positron for the sling	1
suitable aquarium sand	bd aquarium sand	1
sweet part	bd body in dark bley	1
technical greek lexicon	bdag	1
twilight reading	bd ion	1
tyrosine kinase based signaling pathway	bdnf-trkb signaling	1
un-dropped valid sheet border cell	bdr	1
tool	bdt	3
tool	bdc metaman	2
tool	bdc	1
tool	bd development software tool	1
write-once type medium	bd-r	1
write-once type recording disc	bd-r	1
tool	bd	1
tool	bdd examination self report	1
tool	bdd questionnaire	1
project	bdni jakarta	1
project	bdpl reliability	1
artist	bdp	2
artist	bdp's first album criminal minded	1
place	bdsm dot com	1
place	bdc	1
place	bdo	1
technology	bd metrics	1
product	bd- one  body pad 	1
product	bd- ten 	1
product	bd eight  eight-block detector 	1
technology	bde	1
technology	bd probe tec et	1
technology	bd wise	1
term	bdd	1
term	bdeieved	1
parameter	bdnf concentrat ion	1
system	bds	1
system	bdd-based verification system	1
measure	bds test	1
measure	bdi	1
product	bd sixteen h high current block detector 	1
function	bd wise	5
function	bday party	1
device	bd  one hundred d 	2
device	bd atc-xp	1
device	bd burner	1
brand	bd	3
brand	bdo seidman	1
brand	bdi	1
brand	bds tactical	1
concept	bdd	2
concept	bdf	1
site	bdsm adult site	1
task	bdcs relatively low-priority task	1
factor	bdnf	6
