product	bgm	1
initiative	bgmea institute of fashion	3
accessory	bg-e five  battery grip 	1
resource	bgg	1
source	bgr	1
source	bgp speaker	1
work	bg red	1
characteristic	bg horizon	1
institution	bgs	1
client	bg group	3
client	bgc	2
client	bgi	1
client	bg medicine	1
client	bge ltd	1
effect	bgn	1
feature	bgp next-hop	1
field	bga	1
band	bgk	2
part	bga's with no smooth	1
school	bgs nationa public school in hulmavu	1
school	bgs nps	1
school	bgse	1
school	bg	1
operation	bgc	1
type	bga	1
consideration	bg level before eating	1
firm	bgi	4
firm	bgr bloomer	1
firm	bgr energy systems ltd	1
manufacturer	bg	1
instrument	bg's	2
feature	bga pad	1
feature	bgp multipath	1
feature	bgp multi-path	1
attribute	bgcolor	5
attribute	bg color	1
study	bgs risk list	1
unit	bgr public relations	1
unit	bgc sites series	1
feature	bgp tuning	1
format	bgl for scenery	1
Organisations	bgci	1
partner	bgct	1
standard	bgp	1
piece	bg one hundred and eighteen  castle fortress 	1
show	bgt	2
vendor	bg fluids	1
customer	bg group	1
restaurant	bgr in dupont	1
restaurant	bgr burger joint	1
restaurant	bgr the burger joint	1
report	bgs related to meal	1
guest	bg wilma vaught	1
competitor	bge	1
issue	bgp security issue	1
package	bga	5
algorithm	bgp	3
utility	bge	1
utility	bge purchase	1
fish	bg	1
supplier	bgh	1
supplier	bgt	1
protocol	bgp	97
protocol	bgmp	5
protocol	bgp four 	3
protocol	bgpthatdon'tdirectly associatepeerings with interface	1
defect	bga head-on-pillow	1
space	bgp table	1
paper	bgg	1
input	bg color	1
time	bg's game in the fall	1
charity	bgf	1
advanced topic	bgp auto-discovery	1
command	bg in a shell script	1
household name	bg group	1
enzyme	bgl ii	1
advanced technology	bgp	1
design element	bgp best practice	1
datum source	bgp updatesmonitoring	1
hospital	bgs	1
configuration	bga package	2
message	bgp message	1
airport	bgm	1
obstruction	bga package	1
large organization	bgc contracting	1
manager	bgi	2
guest speaker	bgmi youth mentoring	1
international company	bg group	1
international company	bg light	1
map	bgh	1
major	bg group	2
connection	bgp four 	1
communication tool	bgs international exchange magazine	1
communication tool	bgs online member directory	1
key component	bga part	1
institute	bgi shenzhen	1
indication	bg	1
nothing	bgh	1
builder	bgc	1
condiment	bgsk peanut sauce	1
comment	bgmnem best carpet steam cleaner wndwvvf on a regular basis	1
invasive procedure	bgl	1
facet	bg  twenty-four  news 	1
semiconductor device	bga type semiconductor device	1
leisure activity	bg two 	1
critical application	bgp	1
bag	bg fourteen  retro shoulder bag 	1
financial instrument	bg sblc	1
network service	bgp	1
transcription factor	bglg family anti-terminators	1
high profile client	bgp silverstone	1
abbreviation	bg for jobling	1
physical effect	bgn	1
government organization	bgs	1
security issue	bgp security issue	1
broker	bgc partners inc	1
indian company	bgr energy	1
datum service	bgan	1
commercial project	bgan	1
crystal	bgo	2
oil company	bg group	1
area	bgp	1
open standard	bgp	1
school program	bgc	1
faction	bg one	1
critical service	bgp routers	1
intervention program	bgca targeted outreach program	1
electronic part	bga	2
electronic part	bga device	1
commander	bg lawrence morrell	1
service	bgi's offer a solution	2
service	bga x-ray	2
amp	bgw	1
ETFs	bgu	1
ETFs	bgz	1
network protocol	bgp	3
service	bga component removal	1
repellent	bgr	1
ICs	bga	1
complex component	bga	1
specialist company	bg group	1
western company	bg group	2
british company	bg	1
ale	bg sips	1
notable client	bgk	1
topic	bgp optimization	1
internet protocol	bgp	3
background sound	bgm	1
semiconductor component	bga device	11
semiconductor component	bga package	2
distribution company	bge	1
nice extra	bginfo	1
measured value	bgci	1
laptop accessory	bga reballing accessory	1
company	bg group	10
company	bg international	2
company	bgr group	2
company	bgs	2
company	bgw	2
company	bgr energy systems	1
company	bge home products	1
company	bgh	1
investment instrument	bg's	1
oil major	bg group plc	1
oil major	bg group	1
packaging technology	bga	3
company	bg group of the uk	1
company	bg of the uk	1
company	bg products	1
company	bg services	1
routing protocol	bgp	11
company	bgr	1
company	bg medicine	1
large hospital	bgs global hospital	1
live vaccine	bgc against tb	1
potential target	bg group of the uk	1
custom-made product	bga reworks	1
signaling protocol	bgp for the establishment of the virtual circuit	1
traffic type	bgp	1
talent show	bgt	1
complex protocol	bgp	1
component type	bga	1
industry specialist	bgs	1
small package	bga	2
advanced manufacturing technology	bga	1
advanced manufacturing technology	bga assembly process	1
activity	bgs's logo	1
national asset	bg onto the market	1
semiconductor package	bga	4
semiconductor package	bga semiconductor package	1
semiconductor package	bga package	1
advanced package	bga	2
authentication service	bgs	1
energy group	bg group	1
local utility company	bge	1
massachusetts company	bg medicine inc.	1
network layer protocol	bgp	1
scintillators	bgo	2
bank instrument	bg	2
bank instrument	bg's mtn cd's	1
IC device	bga package	1
independent oil company	bg group plc	1
power supplier	bge	1
power utility	bge	1
reliable transport protocol	bgp	2
information	bgcolor	1
information	bgan software version	1
information	bgp routing table	1
IC package	bga	1
network variable	bgp peer	4
best part	bg products	1
miniature component	bga	1
gateway protocol	bgp	5
gateway protocol	bgp track in in in in in in between unconstrained system	1
large utility company	bge	1
interconnection technology	bga	1
marqee attribute	bgcolor	1
event	bg culture	1
initial concept	bga pitch	2
inorganic crystal	bgo	2
oil exploration company	bg group	1
sensible measure	bgf	1
state convention	bgct	1
cable manufacturer	bgg cable	1
control plane protocol	bgp	1
deployment scenario	bgp peering with md five  authentication 	1
event	bgp session restoration	1
restriction site	bgl ii	1
igps	bgp path selection igps	1
program	bgs on-line member directory	1
program	bgs careercentral job board	1
presentational attribute	bgcolor	4
energy major	bg group	1
growth stimulant	bgh	1
long-established firm	bgs d'arcy	1
ma	bgz xy	1
program	bgat	1
program	bgs	1
sound issue	bgm cutting out while playing	1
chip technology	bga	1
complicated protocol	bgp	1
crismatec single crystal	bgo	1
industry standard methodology	bgp	1
MIBs	bgp policy accounting mib	1
supplementary protocol	bgp	1
application layer IP protocol	bgp	1
body attribute	bgcolor	1
circuit board component	bga device	2
circuit package	bga package	2
circuit package	bga package for use with an integrated circuit chip	1
factor	bg control	1
factor	bge ion mobility	1
edit property	bgsound	1
joint venture company	bgl	1
protocol name	bgp four 	2
router protocol	bgp	1
scintillation material	bgo	1
standard JEDECIC package	bga	1
organization	bgc	1
organization	bgf	1
geoscience institute	bgr	1
industry's most successful company	bg group	1
internetrouting protocol	bgp	1
local distribution companys	bge	1
logical grouping	bg one 	1
network security topic	bgp security	1
organization	bge home	1
organization	bga	1
organization	bgs	1
source input device	bgd one  ibridge dock with a single cat- five  cable 	1
source input device	bgd one  ibridge dock with a singlecat- five  cable 	1
source input device	bga one  ibridge adapter 	1
target part	bga	1
typical router high availability feature	bgp multihoming	1
USG standard	bgn	1
advanced microelectronic package	bgas	1
area array package	bga	1
bga rework accessory	bga reballing station	1
bga rework accessory	bga reballing stencil	1
blockbuster show	bgt	1
bully-type breed	bg	1
comparing mild charcoal	bge	1
complex oxide crystal	bgo	1
conventional area array application	bga package	1
covered phenomenon	bgp storm	1
crystal scintillator detector	bgo	1
device package	bga	2
established internet protocol	bgp	1
ETF manager	bgi	1
fantastic sponsor	bgc	1
geological survey	bgs	1
harris communication equipment	bgan satcom terminal	1
induction system cleaner	bg isc	1
law degree	bgl	1
london protocol	bgp	1
mpls-related feature	bgp multipath load sharing	1
network request	bgp peering	1
application	bgp	2
application	bgp weight value	1
professional and major college team	bgsu falcons	1
ready mix concrete supplier	bgc	1
scintillating crystal	bgo	1
scintillation detector	bgo	1
service provider technology	bgp	1
surface built-in semiconductor package	bga	1
triplet	bgb	1
underfill component	bga	1
antitank missile	bgm- seventy-one  tow for long range engagement 	1
area-array package type semiconductor device	bga	1
BACKGROUND RESEARCH package	bga	1
bbqs	bge	1
application	bga s	1
cash-backed bank instrument	bg	1
common border protocol	bgp	1
developement tool	bgt cost money	1
discount bank instrument	bg	1
EGP	bgmp	1
facedown-type semiconductor device	bga	1
name	bg group	1
geological survey organization	bgs	2
heavy scintillating crystal	bgo	1
hockey bag	bg deluxe	1
industrial x-ray application	bga solder inspection	1
inexpensive field screening kit	bgi inc s lead checktm	2
Inorganic scintillators	bgo	1
instant loan	bg	1
institutional analyst	bg bank	1
IP address aggregation information	bgprouting table entry	1
JEDEC standard library	bgas	2
leaded device	bga device	1
miniature package	bgas	1
Multicastroutingproto-cols	bgmp	1
multi-terminal semiconductor package	bga	2
national outfit	bg	1
non-hub airport	bgm	1
optical inspection system	bga software	1
optical inspection system	bga inspection	1
post-recruitment activity	bgv process compliance	1
precise munition	bgm- one hundred and nine d tomahawk land attack missile 	1
PVP option	bg timer	1
reliable phone website	bgr	1
rohs compliant array package	bga	1
sale bank instrument	bg sblc	1
senarios	bg surrenders before confrontation	1
signicant event	bgp session restoration	1
simple file name	bg	1
single-sided sealed package	bga	1
single-sided sealed semiconductor device	bga	1
U.S. equipment supplier	bg technologies llc	1
advanced gasification scheme	bgc slagger	3
advanced networking protocol	bgp	1
area-array type IC package	bga	1
awful deck	bg infect	1
bare trust	bgt	1
BGG photo	bgg picture museum project	1
boundaryconditi -on	bgt	1
certified sportscards	bgs	1
channel design technique	bga pin backdrill	1
common packaging technology	bga packaging technology	1
concrete specialist	bgsb's project manager	1
considerable fixed cost	bg production facility	1
currently ferroelectric crystal	bgo	1
developmentally appropriate structured education program	bgat	1
diffrernts rapper	bgiff young savior	1
discount enhanchments	bgs	1
group	bgf	1
EGP protocol	bgp	1
electro optic crystal	bgo	1
financed project	bg's in egypt	1
fine-pitch ICs	bga	3
first, single chip package	bga	1
floppy distribution	bg-rescue linux	1
fuel addative	bg  two hundred and fourty-four 	1
Gameboy emulator	bgb	1
grid array semiconductor device package	bga package	1
hardy microorganism	bg spore	1
high density electronic part	bga	1
high density package	bga	1
high-density LSI package	bga	2
group	bgsu alumni	1
group	bga	1
inmarsat mobile broadband service	bgan	1
intense assembly issue	bga design	1
international internet retailer	bgn group in netherlands	1
Internet routine protocol	bgp	1
INTRODUCTION Flip-chip technology	bga	2
laminate package type	bga package	1
large plastic component	bga	1
long-term connection	bgp connections between router	1
loose protocol	bgp	1
maryland utility	bge	1
maryland's large electric utility	bge	1
more-effective, less-expensive solution	bge's voluntary peakrewards program	1
multistage RS method	bgp four 	1
network listener	bgp listener	2
network-related protocol	bgp	1
non-heritage organization	bgs	1
method	bgp	2
path vector protocol	bgp	1
path-vector control protocol	bgp	1
path-vector protocol	bgp	2
perimeter package	bga package	1
pitch IC	bga	1
psycho-educational intervention training program	bgat	1
registered future commission merchant	bgc financial lp	1
reussie label	bgo records	1
router -metric	bgp performance	1
satellite cellular technology	bgan	1
semiconductor package substrate	bga substrate	1
SH-type surface acoustic wave	bgs wave	1
single-computer graph algorithm library	bgl	1
slow crystal	bgo	1
state-of-the-art transmission system	bgan	1
substrate-based package	bga	1
suitable IC package	bga	1
sulfur-based repellent	bgr	1
surface-mount type semiconductor device	bga substrate	1
thermally sensitive area	bga land	1
tutu-specific mod	bg one  npc project 	1
utilising internet standard	bgp	1
water-based acrylic gypsum plaster adhesive	bgc stud adhesive	1
tool	bga methodology	1
project	bgis	1
material	bgo	3
place	bgi in shenzen	1
player	bgr energy	1
player	bgc	1
technology	bgp	4
product	bg moa	1
technology	bgp multihoming technology	1
parameter	bga substrate thickness	1
system	bglii	1
species	bgl	1
measure	bg measurements at home	1
element	bg	1
device	bga package	1
component	bga device	6
component	bga	4
component	bga ccga	1
component	bga package	1
component	bgas	1
site	bgp monitoring site	1
site	bgr	1
site	bgafd	1
product	bgm	1
