product	bzp	1
ingredient	bzp	1
agent	bz	1
drug	bzp	1
drug	bz anxiolytics	1
drug	bzp pill	1
substance	bzp	5
country	bze	1
region	bz receptor rich region	1
destination	bze	1
package	bzip two 	3
algorithm	bzip two 	3
bank	bz wbk	2
user	bzt	1
family	bzip	1
finish	bzp	1
commercial product	bzt waste digester	1
ligands	bzbth  two  b 	1
research	bzt	1
transcription factor	bzip	1
agonists	bz site full agonists	1
prison	bzya n zi in dowa	1
advertising agency	bzz agent	1
harmful ingredient	bzp & tfmpp in frozen	2
harmful ingredient	bzp & tfmpp	1
administrative agency	bza	1
xenobiotics	bzp	1
illicit drug	bzt	1
hallucinogen	bzt	1
art method	bz-mag  three 	2
op	bzn	1
allopathic medicine	bzon	1
compression program	bzip two 	1
azoles	bzt	1
standard utility	bzfrac	1
compression tool	bzip two 	1
party drug	bzp	1
traditional customer	bzd	1
regulatory gene	bzip transcription factor	1
full agonists	bz site full agonists	1
information	bzzagent track certain information	1
rich region	bz receptor rich region	1
event	bzzr garden	1
transcription factor family	bzip protein	1
legal stimulant	bzp	1
lipophilic medication	bzd	1
popular compression algorithm	bzip two 	1
non-equilibrium system	bz system	1
flaming turd	bzh	1
prominent armenian royal house	bznuni	2
amphetamine type stimulant	bzp	1
common generic text compressor	bzip two 	1
electroceramics	bzt	3
web provider	bz results	1
actual ingredient	bzt	1
piperazines	bzp	4
BZ weapon	bz in bullet	1
innovative vehicle	bzw's equity portfolio-crossing service	1
worldwide telecom approval	bzt	1
active control group	bzra group	1
binary compressor	bzip two 	1
cultural-linguistic group	bzh	1
good datum compression technique	bzip	1
military agent	bz	5
multi-platform general-purpose compression program	bzip two 	2
open sourced component	bzip two  data compressor 	1
polish bank	bz wbk	1
purpose compression tool	bzip two 	1
shell program	bzip two 	1
solid agent	bz	1
universal lossless datum compressor	bzip two 	1
basic dedicated map editor	bzedit	1
detectable azole concentration level	bzt	1
DVCSs	bzr	1
good VCS	bzr	1
high risk drug use	bzds for period of time	1
melanoma imaging agent	bza	1
oscillatory chemical system	bz reaction	1
principal COC metabolite	bze	1
pythonique backends	bzr	1
quaternary ammonium active ingredient	bzt	1
year piperazines	bzp	1
tool	bzip two 	1
system	bz reaction	1
