accessory	ck performance accessory	1
resource	ck- twelve  flexbooks 	2
property	ckbr	1
benefit	ckc co-op benefit	1
subject	ckd-related anemia	1
exception	cksb in winnipeg	2
model	ck score	1
model	ckls model	1
category	ckd	1
client	ck tang	1
mechanism	ckk level	1
film	cky two k 	1
film	ck deserters	1
band	cky	5
firm	ck life sciences	1
test	ck	3
test	ck isoforms	1
manufacturer	ck	3
act	cky	1
feature	ck exclusive remix	1
complication	ckd-related metabolic complication	1
individual	ckg	1
website	cky books	1
unit	ckr	1
musician	ck mann	5
show	cky	1
club	ckc	1
customer	cke restaurants	2
customer	ckw ag	1
label	ck	2
label	ckm	1
risk factor	ckd risk factor	1
destination	cks memorial hall	1
party	ckua	1
protein	ck two  kinase 	1
good	ckd car	2
brand name	ck	5
legend	ck nayudu	1
possibility	ckp	1
image	cki- one  level in cul- two 	1
landmark	cks memorial	1
university	ckit in toronto	1
university	ckitin toronto	1
university	ckut in montreal	1
university	ckutin montreal	1
tourist attraction	cks memorial hall	1
top brand	ck	3
top brand	ck jeans	1
association	ckc	5
chain	cke restaurants inc.	1
result	ck	3
station	ckua	2
station	cklg	1
station	ckcu	1
station	ckn	1
station	cklw  eight hundred am 	1
illness	ckd	1
gene	cks two 	1
gene	cks one b 	1
breed	ckcs	1
poet	ck williams	1
outlet	cknw	1
marker	ck-mb	2
marker	ckm	1
marker	ckmb	1
enzyme	ck	7
enzyme	ck b	1
enzyme	ck mb	1
big company	ck	6
local company	ckws television	1
famous brand	ck and burberry	1
surgery	ck	2
international brand	ck	1
quality brand	ck	1
diagnostic test	ck-mb	2
radio station	ckrz  one hundred . three  fm in brantford 	1
radio station	cklw in detroit  one thousand nine hundred and sixty s 	1
chronic disease	ckd	1
big brand	ck	1
garment	ck underwear	1
editor	ckeditor	2
comment	ckzoke watch movies online ciwxlwq common	1
performance accessory	ck performance accessory	1
designer brand	ck	1
top company	ck	2
biomarkers	ck-mb	2
biomarkers	ckmb	1
blood test	ck-mb	1
indian company	ck birla group	1
operational parameter	ckd type	1
surgical technique	ck	1
top brand name	ck	1
medium company	ckxt-tv	1
top manufacturer	ck	1
designer label	ck calvin klein	1
popular tourist destination	cks memorial hall	1
tour operator	ck verbier	1
inflammatory disease	ckd	1
affiliate	cky	1
fashion brand	ck	1
lab test	ck	1
lab test	ck enzyme	1
rare disease	ckd	1
patient datum	ck-mb	1
kinases	ck two 	1
registry	ckc	4
registry	ckc-continental kennel club	1
registry	ckc - in the states is continental kennel club	1
service	ckd added in vmi model	1
remote place	ckv	1
Co-morbidities	ckd	1
tumor marker	ck bb	1
biochemical marker	ck-mb	3
complex disease	ckd	1
top model	ck	1
special event	ckrh special event	1
designer line	ck	1
perfume	ck	1
serum marker	ck-mb	2
leading name	ckc & sons	1
plugin	ckeditor	1
routine laboratory test	ck	1
topic	ck procedure	1
fragile material	ckn	1
debt collector	ck edrupt	1
recruitment agency	ck clinical	1
recruitment agency	ck regulatory	1
recruitment agency	ck science	1
recruitment agency	ckr	1
recruitment agency	ck healthcare	1
serif font	ck newsprint	1
american poet	ck williams	1
designer clothes	ck	1
metabolic complication	ckd-related metabolic complication	1
company	ckc engineering	1
company	cke restaurants inc.	1
company	ckp	1
heritable trait	ckdn two a mutation 	1
PDF document	cks user guide	1
civic event	cknw vancouver orphan's fund	1
parsers	cky	3
parsers	cky parsers	2
popular medium	ck prahalad's fortune at the bottom of the pyramid	1
amazing event	ck lingerie	1
catabolic condition	ckd	1
UNIX utility	cksum	1
refractive surgery	ck	6
cardiac biomarkers	ck-mb	3
cardiac biomarkers	ck	1
covariables	ckd in the baseline period	1
soil additive	ckd	1
cardiac marker	ck-mb	4
refractive procedure	ck	1
branded handbag	ck jeans	1
distinctive brand	ck	1
information	ck level	2
jewelry brand	ck	1
rock music	cky	1
medical co-morbidities	ckd	1
brand-names	ckt	1
independent station	ckua	2
independent station	ckcu	1
independent station	ckut	1
muscle enzyme	ck	2
national registry	ckc	1
call letter	cklw in detroit	1
soluble marker	ckmb	1
soluble marker	ck-mb	1
desirable brand	ck	1
kennel club	ckc	2
biomarker	ckmb	1
typical test	ck	1
conventional marker	ck	1
expensive designer	ck	1
injury marker	ck-mb	1
lower-priced brand	ck	1
overseas expert	ck connors	1
enzyme marker	ck isoenzyme mb	1
fresh fragrance	ck truth	1
program	cksum	1
cardiac protein	ck-mb	1
foremost manufacturer	ck	2
Highlife hot-shots	ck mann	1
legendary station	cklw	1
top-of-the-line IEMs	ck ten 	1
amazing professional vendor	ck catering	1
authentic branded perfume	ck	1
big brand jewellery name	ck	1
brand counter	ck	1
designer perfume brand	ck	1
designer watch brand	ck	1
factor	ckd risk factor	1
enzyme test	ck	4
integrable hierarchy	ckp	1
part -logistic service	ckd management	1
refractive eye surgery	ck	1
respected business	cki soccer & the edge sports training centers	1
routine labor atory test	ck	1
swatch group brand	ck watch & jewelry	1
well-known quality brand	ck tools	1
apparel stock company	ck &	1
country station	ckqm peterborough	1
country station	ckry calgary	1
organization	ckn	1
organization	ckln	1
laser eye treatment	ck	3
lobster product	ck	1
men's line	ck	1
music ststions	cklg	2
music ststions	ckwx	2
technique	ck	3
registered broker	cks equities	1
simply main model	ck	1
swatch brand	ck hamilton	1
world-renowned thought leader	ck prahalad	1
cytosolic marker	ckmb	1
fake labeled good	ck jeans	2
high-end mixed brand name	ck	1
international first-line lingerie brand	ck	1
legitimate breed association	ckc	6
musky scent	ck euphoria	1
necrotic marker	ck-mb	1
parsing strategy	cky	1
powerhouse clear channel station	cklw in windsor	1
purebred registry	ckc	1
Stateless offloads	cko	1
vital business resource	ck form	1
cementitious additive	ckd	1
chsaa's top player	ck's lamar odom	1
CKT	ckt  four hundred and ten 	1
CKT	ckt  four hundred and twenty 	1
elective refractive procedure	ck	2
endogenous biological marker	ck-mb	1
name	ckp	1
fire protection district	ckfr	1
indiscriminate registry	ckc	1
Leading cardiac analytes	ck-mb	1
postoperative hemodynamic parameter	ck-mb	1
Registries	ckc	3
rich text area replacement add-ons	ckeditor	1
scam registry	ckc	1
Serum cardiac biomarkers	ck-mb	1
specialist scientific recruitment agency	ck regulatory	1
specialist scientific recruitment agency	ck clinical	1
steel insert	ckamping collor	1
american ad camp	ck jeans	1
american ad campaign	ck jeans	1
anti-V-domain MAbs	ck five 	1
option	ckeditor	1
bespoke lighting configuration package	ck light system manager	1
cardio marker test	ckmb	1
checksum program	cksum	1
CKCSC champion	ckcsc & akc ch	2
eliminating dedicated pin	cke pins in a sdram system	1
established cardiac marker	ckmb	1
forum -metric suite	ck	1
globally well-known shoe brand	ck	1
group	ckc	1
group	ck twelve 	1
MVC friendly control	ckeditor	1
national and local TV	ckvu tv	1
nickel-iron meteorite	ck carbonaceous chondrites	1
object-oriented metric suite	ck suite	1
online WYSIWYG HTML editor	ckeditor	1
ornamental and dingbat font	ck glyph	1
private CBC affiliate station	ckws in kingston	1
resort-specific operator	ck verbier	1
retail scrapbook convention	ck convention	1
separate card	ckvm card	1
sexual price	ck of swatch group	1
Solar NGOs	ckn	1
ST-segment elevation myocardial cardiac myonecrosis	ck-mb in the context of infarction	1
sweet -floral	ck euphoria blossum	1
tra-ditionaloo -metric suite	ck	1
wysiwyg editor library	ckeditor	1
tool	cksum	1
artist	ckg	1
place	ck tang	1
technology	ckfx platform	1
brand	ck	13
brand	ck calvin klein	8
brand	ck jeans	3
brand	cko	1
brand	cke restaurants	1
brand	ck calvin klien	1
brand	ck products	1
brand	ckett & d brentwood	1
brand	ck tools	1
brand	ck watches	1
site	ck twelve 	1
