datum	cw output variation with bias current	1
resource	cws office	2
resource	cwjc newsletter	1
facility	cwa community centre	1
process	cwc two  developer 	1
source	cwgc	1
word	cw skimmer keygen	1
situation	cw sweepstake	2
institution	cwc	1
client	cw jobs	1
author	cwn	1
form	cwaedon	1
person	cw morse	1
matter	cwa	1
alternative	cwb pricing alternative	1
agency	cwa	1
object	cwaxis object	1
object	cwpointer object	1
book	cwb	1
structure	cwd	1
business	cws	1
development	cwc	1
venue	cwmfelin club	1
venue	cwa international day	1
town	cwmbran	2
firm	cw capital	2
firm	cwr mobility	1
indicator	cwd accumulation	1
favorite	cwb	1
publication	cwb	1
setting	cw pitch	1
class	cws	1
leader	cwa's larry cohen	1
expense	cwa  four hundred and one k employer contribution 	1
mean	cwg	1
entity	cwsa in ghana	1
feature	cw	1
Organisations	cwa	3
standard	cwm	3
classic	cwm rhondda	1
show	cw's focus atlanta	1
customer	cws	1
effort	cw's online nation	1
effort	cwm	1
scheme	cwss	1
exercise	cwid	1
party	cwc	1
competitor	cwb	1
performer	cw anderson	1
law	cwa	1
channel	cw	3
channel	cw channel	1
suggestion	cwc radio station	1
university	cwru	1
tourist attraction	cwmbran manor	1
operator	cwc	3
operator	cw panama	1
network	cw	27
singer	cwassicaw crossover artist andrea bocewwi	1
force	cwp	1
mode	cw	3
mode	cw doppler	1
authority	cwa	1
standard feature	cw keyer	1
issue	cwip in rate base	1
local organization	cwa	1
annual event	cwid	1
NGOs	cwin	1
signal	cw	2
charity	cwf	1
oil	cwf	1
programme	cwsn	1
command	cwo	1
personal item	cw key	1
TV show	cw's the vampire diaries	1
quantity	cwp	1
employee	cw two 	1
international organization	cwi	1
code	cwoe	2
community group	cwa	2
community group	cwa meeting	1
interest group	cwa	1
opponent	cwu	1
local group	cwa	1
rural area	cwmott in cwmbran	1
promotion	cwf mid atlantic	1
certification	cwna	4
certification	cwi	1
certification	cwm	1
light source	cw lamp	1
set	cw's vampire diaries	1
online tool	cwu's blackboard	1
item	cw message memory	1
designation	cwf	1
federal agency	cwa	1
mega event	cwg	1
statute	cwa	4
union	cwu	2
union	cwa	2
union	cwu in the post	1
cultivars	cw  nine hundred and ninety l 	1
federal program	cwa	1
television series	cw's vampire diaries	1
subsidiary	cwe printers	1
consultant	cwg knowledgeable consultant	1
area	cwm-yr-eglwys	1
profile	cwsa	1
small gift	cwc pen	1
free tool	cw shredder	1
campus	cwu	1
impairment	cw interference	1
reputable brand	cwp instruments	1
federal law	cwa	2
local school	cw post	1
sect	cwi	1
certificate	cwi certificate	1
treaty	cwc	8
top manufacturer	cwp	1
commercial project	cwa pinnacle	1
acronym	cwot	1
open standard	cwm	1
local community	cwm-yr-eglwys	1
religious organization	cws	1
analytes	cw agent	1
state institution	cwe	3
state institution	cwa	1
scandal	cwg	1
chinese company	cwe	2
area	cwe	1
ongoing program	cwi	1
online community	cwop	1
engineer	cwf hamilton	1
supplementary service	cw	2
fix	cwshredder for removing coolwebsearch	1
service	cwm	2
service	cw	1
conservative group	cwa	1
business entity	cwm development company	1
professional certification	cwm	1
service	cwo	1
recreation	cwr titan	1
spectroscopic technique	cw photoluminescence	1
television network	cw	1
rank	cwo	1
federal statute	cwa	3
scam	cwg	5
free application	cwshredder	1
private facility	cwa hall	1
clone	cw fourty-four 	1
industry certification	cwsp	1
variable parameter	cw min	1
variable parameter	cw max	1
TV network	cw	2
intelligent feature	cwdm gbic support	1
treatment system	cw	1
inspection service	cwi	1
notable event	cwcmf cup tennis team tournament	1
cable operator	cwc	1
labor union	cwa	1
relative newcomer	cw park	1
company	cwt	2
labor organization	cwa	1
group member	cwg	2
mobile network	cwo	1
regulatory program	cwa	2
broadcast network	cw	1
certification exam	cwsp exam	1
company	cwb	1
company	cw framers	1
place-names	cwm corryn near llanaelhaearn	1
faith-based group	cws	1
laser system	cw co two 	2
community bank	cwb	1
deal program	cwa	1
company	cw network	1
company	cwu	1
company	cwx	1
Aussies	cw stoneking	1
environmental statute	cwa	3
digital mode	cw	2
card information	cw two  code 	1
non-newtonian fluid	cwf	1
bistro	cwtch in pembrokeshire	1
command-line tool	cwconfig provided with rme	1
network site	cw.com	1
pro-life group	cwa	1
activity	cwg meeting	1
job portal	cwjobs	1
national certification	cwi	1
controller parameter	cw id	1
interoperability standard	cwm	1
chassis part	cwp gear	1
traditional mode	cw	3
union group	cwu	1
commercial network	cw	2
relief program	cwa	1
welfare group	cws	1
certs	cwi	1
emergency relief supply	cws health	3
federal environmental law	cwa	1
cleanup tool	cw shredder	1
reputed institute	cwi	1
tuning company	cwest global auto	1
MFC class	cwinapp	2
district initiative	cwm	1
famous aviator	cwa scott	1
mismatch	cwb	1
network channel	cw	1
event	cwg	2
event	cwgs	1
online training course	cwasp	1
event	cw game	1
event	cwf	1
TV new channel	cw eleven 	1
game site	cwg village	2
horse feed & supplier	cwg ltd located in lincolnshire	1
indy fed	cwf	1
silicone adhesive	cw- fourteen - seven hundred and thirty-six  available from specialty tapes 	2
event	cwa party night	1
global tool	cwr portal	1
evangelistic method	cwt	1
financial management system	cwf	1
program	cwa	2
program	cwppra	1
program	cwshredder	1
object-oriented programming language	cwell rocky	1
popular TV channel	cw	1
remarkable preparation product	cwsp pw zero - two hundred and four  cwna from test king intereactive testing engine online 	1
circumstantial information	cw- two  pike's account of the accident 	1
program	cw's waterbury method	1
program	cw	1
customized program	cwt	1
global regime	cwc	2
program	cwru weatherhead school of management	1
program	cw's supernatural'', dealing with popular folklore	1
program	cw comedy drama	1
program	cweta	1
program	cwa nonpoint source planning	1
metamodels	cwm	1
online recruitment site	cw job	1
optical transceiver	cwdm gbics	3
optical transceiver	cwdm sfps	3
provider agency	cwla member emq families first in campbell	1
trail centre	cwn carn	1
vest brand	cwb	1
custom recovery	cwm recovery using the fastboot	1
custom recovery	cwm using fastboot	1
high speed signal	cw	1
high-politics international non-proliferation regime	cwc	1
local broadcast network	cw	1
organism-level endpoint major EPA statute	cwa	1
organization	cwin	3
acoustic tool	cwt	1
active MP retiree	cw five  phil tackett 	1
active MP retiree	cw five  willie rowell 	1
broadcast competitor	cw	3
district award	cwi of the year	1
organization	cws	1
humanitarian partner	cws	1
low power mode	cw	1
organization	cwc	1
postwar development	cwmbran	1
specialty album	cwp	1
tights	cw-x insulator stabilyx tights	1
analog transmission system	cw	1
basic disease factor	cwd origin	1
big labor group	cwa	1
circuit pack	cwdm circuit pack	1
commitment document	cwo's	1
common pneumoconioses	cwp	1
complex oxide crystal	cwo	1
established australian artist	cw stoneking	1
fancy letter	cwe	2
feed system	cwp	1
fiber optic transmission equipment	cwdm	1
firearm training	cwp course	1
high duty cycle mode	cw	1
landmark treaty	cwc	1
narrow-band mode	cw	1
non-am mode	cw	1
application	cw	2
private gym	cw fit	1
pro-environment law	cwa	1
prominent construction company	cw driver	1
pro-vote member group	cwa	1
small show	cw's online nation	1
social and support group	cwa	1
speciality mode	cw narrow	2
specialty mode	cw narrow	1
spot price index	cwiandthesacr index	1
application	cwshredder	1
application	cw radar	1
application	cw laser	1
application	cworpulsedrfand modulator service	1
terrorist and terrorist-linked violent group	cwp	1
thereare contest	cw contest	1
topological construction	cw-complexes	2
agricultural supplier	cwg in melton mowbray	1
arbitrary FTP command	cwd	1
automatically well-known anti-spyware program	cwshredder	1
centrist organization	cwi	1
constant carrier mode	cw	1
constant-frequency signal	cw	1
dunsborough community group	cwa	1
ELCA partner	cws	1
entrepreneurial firm	cwt	1
fiery utility	cwpt	1
forestry commission centre	cwmcarn near newport	1
formalized cooperative process	cwppra	1
hardship fund	cwac	1
high precision mode	cw	1
HWTS	cwp	1
IABC international publication	cw bulletin	1
industry meta model standard	cwm	1
large scale scam	cwg scam	1
laser light beam	cw laser	1
case	cwg	2
local 3PLs	cwt	1
low duty-cycle mode	cw	1
maintenance test pilot	cw three  don griffith of alpha company 	2
materiel solution	cwb replacement	1
MFC GUI class	cwnd	1
modular monosynths	cwejman s one  mkii 	1
narrow band signal	cw	1
peak rural group	cwa	1
case	cw pumping	1
case	cwa	1
predefined workflowsas product	cwm structure comparer	1
predefined workflowsas product	cwm lead finder	1
regional coastal wetland restoration effort	cwppra	1
respected local and national charity	cwf	1
servicers firm	cw capital	1
slender pipe structure	cwp	1
steady buyer	cww	1
underdog show	cw's supernatural	1
UPA regime many scam	cwg	1
visible laser diode product	cw component	1
wavelength-division multiplexing technology	cwdm	2
option	cwp with special tags for ios	1
Background STE s	cwb	1
canadian regulatory marketing institution	cwb	1
car allocation arrangement	cwb's block shipping system	1
clear coat sealer	cwf for cedar	1
compression tights	cw-x stability tights	1
CW decoding software	cw decoderxp	1
CW laser	cw co two 	1
group	cwl	2
group	cwa	2
group	cws	2
emission mode	cw	1
established garden	cwf demonstration garden	1
family-friendly group	cwa	1
federal and state environmental law	cwa	1
federal-and-state-sponsored program	cwppra	1
field gear	cwt detector	1
great consortias	cwt specialized on corporate segment	1
high caliber financial service firm	cw financial services	3
High grade magnetite iron ore	cwrn baja california	1
high rise crowded area	cwb	1
independent ministry	cwr founded by selwyn hughes	1
group	cwlp's energy forums	1
intense supplemental metabolic conditioning	cwt	1
intermittent beat signal	cw signal	1
locally contractible space	cw complex	1
low bandwidth mode	cw	1
MFJ accessory	cw reader	1
narrow mode	cw	1
narrow-band interference signal	cw tone	1
narrow-band situation	cw on hf	1
net HD signal	cw	1
nonuniformed union	cwa	1
optical access technology	cwdm	1
private weight management program	cwp	1
recognizable lender name	cw capital	1
recommendation educational program	cweb	1
research campus	cwru	1
sealer coat	cwf	1
sensitivity slow sensor	cw sensor	1
siliconeadhesives	cw- fourteen - seven hundred and thirty-six  available from specialty tapes 	1
slim 9mm	cw nine 	1
specialty endorsement	cw only	1
spectroscopic instrument	cw cavity ring down spectrometer based on lead salt diode laser	1
strict security procedure	cwa procedure	1
TPH analysis	cws-phc method	1
underground channel	cwm ogof on the neath	1
unmodulated mode	cw	1
vanity company	cwp	1
well-behaved space	cw complex	1
ZBOs	cwi	1
tool	cwr mobility	1
tool	cw shredder	1
project	cwc	1
artist	cw buchanan	1
place	cwl	1
place	cwm carn	1
system	cwc	1
element	cwd enhancement	1
variable	cw j	1
device	cw gas dynamic co.sub. two  laser 	1
brand	cwf flood finish	2
site	cwm hir abbey	1
