product	czw	1
product	cz earring related product	1
product	cz pearl bracelet related product	1
initiative	czech republic	1
game	czech computer game	1
subject	czech language	1
exception	czech republic	10
exception	czechoslovakia	1
exception	czyzewski's criticisms of heritage's treatment of reflexivity	1
character	czar	1
institution	czech tourism	1
institution	czech centers	1
institution	czech constitutional court	1
institution	czech central bank	1
institution	czechinvest other institution	1
document	czechoslovak democratic scouts in exile organization	1
document	czerniakow's diary	1
author	czarnecki et al.	1
product	cz jewelry set related product	1
product	czech glass	1
form	czech marionette	1
person	czechoslovak president vaclav havel	1
effect	czochralski vs. float-zone starting material	1
course	czech study	1
location	czech republic	7
writer	czeslaw milosz	4
writer	czeslav milosz	1
writer	czech milan kundera	1
solution	czar	1
star	czech tennis star	1
film	czech commercial hit pupendo	1
band	czerwone gitary	2
title	czar with the russians	1
title	czech republics black-and-white rotoscope film alois nebel	1
feature	czech language feature	1
venue	czar bar	1
venue	czar	1
town	czenstochow	1
town	czersk	1
firm	czech law firm	1
drug	czx	1
favorite	czarnina	1
instrument	czech mark instrument	1
man	czar nicholas	1
man	czech-born josef frantisek	1
man	czartoryski	1
study	czech twin	1
figure	czerny	1
basic	cz jewelry	1
leader	czar	1
leader	czech republic	1
instance	czech republic	1
team	czech republic's top team sc sparta-praha	3
team	czech republic	1
team	czechoslovakia	1
country	czech republic	1178
country	czechoslovakia	113
country	czech	18
country	czarist russia	2
country	czech rep.	2
country	czech republ ic	2
country	czechia	2
country	czech repbulic	1
country	czech republic fourty-six 	1
country	czech poland	1
country	czech republic?with lower inflation	1
country	czech region	1
country	czech land	1
region	czech republic	9
region	czech rep ublic	1
partner	czech republic	1
influence	czech surrealism	1
influence	czech photographer josef sudek	1
critic	czech prime minister mirek topolanek	1
market	czech republic	29
market	czechia	1
customer	czech post benefit through lower administrative cost	1
step	czardas	1
designer	czeslaw knothe	1
award	czechoslovakia medal	1
student	czar	1
exercise	czerny exercise book	1
exercise	czerny	1
destination	czech republic	4
destination	czestochowa	1
party	czech opposition party	1
offer	cz ring related offer	1
occasion	czar's birthday	1
good	czech baked good	1
state	czech republic	24
state	czechoslovakia	6
state	czech pepublic	1
local tourist attraction	czech national museum	3
festival	czech rep & ultrashock	1
great	czerny	1
language	czech	82
language	czechoslovakian	2
language	czech, other language	1
herb	czech lavender	1
line	cz stone	1
university	czech technical university	1
issue	czar	1
composer	czerny	2
association	czech association	1
authority	czech custom	1
sponsor	cz	1
college	czech university of life science	1
annual event	czech heritage festival	1
politician	czechoslovakian president tom&aacute;s masaryk	1
veteran	czechoslovakian	1
society	czechoslovakia	1
society	czech	1
society	czechoslovakia under communism	1
time	czech wolf hybrid	1
breed	czechoslovakian wolfdogs	2
breed	czechoslovakian vlcak	1
carrier	czech airlines	1
suspect	czk	2
county	czech republic	5
enterprise	czech cez group	1
nation	czech republic	43
nation	czechoslovakia	22
nation	czechs	2
nation	czarist russia	1
investor	czech exim bank	1
goodie	czech copper bead	1
rider	czech radomir simunek	1
church	czechoslovakian baptist church	1
family	czartoryski	1
family	czernin	1
fighter	czech adamek	1
code	cz for czech	4
notable exception	czech republic	1
notable exception	czechoslovakia	1
master	czerny	2
master	czar nicholas of russia	1
power	czechoslovakia	1
airline	czech airlines	6
airline	cz	2
kind	czar	1
painter	czech cubist painter	1
jurisdiction	czech republic	6
trade	cz  seventy-five 's 	1
craft	czech glass	1
craft	czech folk craft	1
performance	czech baby jesus	1
promotion	czw	3
international company	czech energy producer cez	1
ethnic group	czechs	6
item	czech music sheets	1
donor	czech republic	5
contributor	czech office for personal data protection	1
variant	czech nymph	1
orchestra	czech philharmonic	3
orchestra	czech national orchestra	3
orchestra	czech philharmonic orchestra	1
non-governmental organization	czech helsinki committee	2
product line	czech model	1
economy	czech republic	3
economy	czechoslovakia	1
ensemble	czech radio symphony orchestra	1
item	czech fire polish	1
popular destination	czech republic	2
locale	czech	2
beer	czech kozel	1
mod	cz engine support hl mod	1
tournament	czech open	1
government	czech republic	1
neighbor	czech republic	4
stones	cz pink sapphire	1
stones	cz lemon citrine	1
stones	cz blue topaz	1
stones	cz	1
stones	cz amethyst	1
statute	czma	4
public event	czech national library	1
detector	czt	4
gun	cz- fifty-two 	2
gun	cz	1
gun	cz eighty-two 	1
gun	cz fifty-two 	1
ally	czech republic	2
ally	czechoslovakia	1
regular	czar of the bike valet jim shirk	1
government department	czar	1
cultivars	czar	1
souvenir	czech jewellery	1
minority	czechs	7
market leader	czech republic	4
partnership	czajkowski & kielbuscewicz	1
peoples	czechs	2
area	czech republic	2
quality material	czech & lamp work beads	1
quality material	czech glass	1
quality material	czech fire-polished glass	1
high quality material	czech glass	1
territory	czech republic	1
minority group	czechs	2
world leader	czech president vaclav klaus	1
travel spot	czestochowa	1
farmer	czeslaw majewski	1
developed country	czech republic	2
baked good	czech baked good	1
european country	czech republic	74
european country	czechoslovakia	4
european country	czech	3
european country	czech of republic	1
computer game	czech computer game	1
crystal	czech-made crystal	2
dog breed	czech wolfdogs	1
top star	czw's ruckus	1
law firm	czech law firm	1
member state	czech republic	52
nationality	czechs	4
nationality	czechoslovakian	1
victim	czechoslovakian general secretary rudolf slansky	1
gemstone	cz evileye	1
pianist	czerny	1
clinician	czech physician bohuslar kocab	1
rifle	cz  four hundred and fifty-two 	1
rifle	czech mause	1
beautiful place	czech capitol	1
democracy	czech republic	3
semiconductor	czt	2
immigrant	czech	1
production company	czech connection	1
summer program	czech-american summer music institute	1
international group	czech nonet	1
neighboring country	czech republic	2
authentic material	czech newspaper	1
international festival	czech republic	3
opposition party	czech opposition party	1
firearm	cz- seventy-five 	2
bead	czech glass	3
bead	czech round glass bead	1
bead	czech glass bead	1
neighbouring country	czech republic	6
historic figure	czech teacher-scientist protestant bishop john amos comenius	1
mature market	czech republic	1
developing country	czech republic	2
member country	czech republic	3
emerging market	czech republic	4
small state	czech republic	1
international airline	czech airlines	1
exotic locale	czech republic	1
american author	czeslaw milosz	2
highest quality material	czech art glass	1
large market	czech republic	1
Europeans	czech jan koller	1
third world country	czechoslovakia	1
modern author	czeslaw milosz	1
federation	czechoslovakia	1
regional logo design	czech republic logo design	1
rich country	czech republic	1
local market	czech republic	2
international carrier	czech airlines	2
pistol	cz- eighty-two 	1
pistol	cz seventy-five 	1
advanced country	czech republic	1
european nation	czech republic	2
growth market	czech republic	2
trading partner	czechoslovakia	1
regional market	czech republic	1
sausage	czech sausage	1
topic	czech art	1
topic	czech surrealism	1
count ries	czech republic	2
secondary market	czech republic	1
overseas market	czech	1
large country	czechoslovakia	1
established market	czech republic	1
international location	czech republic	1
industrialized country	czechoslovakia	1
monarch	czar peter the great of russia	1
european leader	czars	1
EU country	czech republic	18
full-access bonus site	czech sex club	1
big team	czech republic	1
political entity	czech republic	1
european destination	czech republic	2
socialist country	czechoslovakia	4
socialist country	czech republic	2
modern weapon	czech rm- seventy 	1
middle-income country	czech republic	3
advanced economy	czech republic	1
host country	czech republic	2
classic material	czech glass	1
handgun	cz- eighty-two 	1
year country	czech republic	1
european market	czech republic	5
OECD country	czech republic	3
communist country	czech republic	11
communist country	czechoslovakia	4
democratic state	czech republic	1
small economy	czech	1
small economy	czech republic	1
key country	czech republic	1
eastern european country	czech republic	74
eastern european country	czechoslovakia	9
european state	czech republic	4
european state	czechoslovakia	2
helmet	czech helmet	1
renowned orchestra	czech philharmonic orchestra of budweis	1
U.S. ally	czech republic	1
western nation	czechoslovakia	1
national minority	czechs	2
goalie	czech legend dominik hasek	1
matching piece	cz earring	1
northern country	czech republic	1
tennis star	czech tennis star	1
european carrier	czech airlines	1
compound semiconductor	czt	1
EU member state	czech republic	16
EU member state	czech	1
european language	czech	4
transition economy	czech republic	12
company	cz from the former czechoslovakia	9
company	cz from czechoslovakia	4
border state	czech republic	1
example country	czech republic	1
western european country	czech republic	1
today country	czech republic	1
eastern state	czech republic	1
non-eu country	czech republic	1
nuclear power	czech republic	1
state initiative	czm data modernization grant	1
transition country	czech republic	13
transition country	czech republic with earlier unspecified law	1
far-flung place	czech republic	1
landlocked country	czech republic	3
landlocked country	czechoslovakia	1
processing tool	czech processing tool	1
company	czw	1
company	cz czechoslovakia	1
company	czerka enslaved entire nonhuman race	1
MS	czech republic	3
small open economy	czech republic	2
american ally	czeckoslovakia	1
bonus site	czech sex club	1
common language	czech	1
medium market	czech republic	1
member nation	czech republic	3
EU member	czech republic	14
national language	czech	1
technical study	czerny	1
transit country	czech republic	1
communist state	czechoslovakia	1
communist state	czech republic	1
network carrier	czech airlines	1
central european country	czech republic	34
central european country	czech	3
central european country	czechoslovakia	2
central european country	czech republik	1
company	czech airlines	1
company	czech cez	1
less-developed country	czech republic	1
popular language	czech	1
european airline	czech airlines	1
east european country	czech republic	10
east european country	czech	2
east european country	czechoslovakia	2
east european country	czech republic from w	1
EU state	czech republic	2
quality name brand product	cz	1
european team	czech republic	1
european team	czechs	1
original piece	czech armchair	1
planning effort	czbllc report	1
famous tourist destination	czech republic	1
tough team	czechs	1
binary	cz cmi	1
european union country	czech republic	1
NATO member	czech republic	1
pyrethroids	czech republic synthetic pyrethroids	1
tongue	czech	2
receiving country	czechoslovakia	1
nobel prize winner	czeslaw milosz	1
transitional economy	czech republic	4
EU nation	czech	1
imported beer	czechvar	3
national entity	czech republic	1
potential investor	czech energy giant cez	1
subdomains	cz . cc	1
time country	czech republic	1
european league	czech republic	1
low-cost country	czech republic	1
NATO country	czech republic	1
notable team	czech republic	1
radical approach	czar	1
eastern bloc country	czech republic	6
eastern bloc country	czechoslovakia	2
global entity	czech republic	1
radical reformer	czech republic	1
surrounding country	czech republic	1
developing economy	czech republic	1
eastern nation	czech republic	2
NATO ally	czech republic	1
slavic language	czech	16
synthetic pyrethroids	czech republic synthetic pyrethroids	1
technical book	czerny	1
candidate country	czech republic	5
CEE country	czech republic	8
CEE country	czeck republic	2
CEE country	czech	1
domestic and international airline	czech airlines	1
musical ensemble	czech philharmony orchestra	1
musical ensemble	czech radio symphonic orchestra in prague	1
eastern european state	czechoslovakia	1
eastern european state	czech republic	1
soviet country	czech republic	1
landlocked state	czech republic	1
tariff	czar-lite published by smc three 	1
established entity	czech catholic union society	1
ghetto	czestochowa	2
medium-sized country	czech republic	1
newly independent country	czech republic	1
nordic country	czech republic	1
second, country	czech republic	2
well-known orchestra	czech national symphony orchestra	1
eastern european nation	czech republic	5
eastern european nation	czechoslovakia	3
energy group	czech republic's cez	2
EU MS	czech republic	1
european event	czernobyl accident	1
language version	czech	1
low and middle income country	czech republic	1
prominent orchestra	czech national symphonic orchestra	1
central and eastern european country	czech republic	7
central and eastern european country	czech republic turkey	1
close U.S. ally	czech republic	1
disease-resistant variety	czar	1
established country	czech republic	1
inflected language	czech	1
synthetic language	czech	4
world-renowned orchestra	czech national symphony	1
allied force	czechoslovakia	1
female director	czech republic's vera chytilova	1
glass bead	czech glass bead	1
great country	czechoslovakia	1
jewelry component	czech glass	1
market nation	czech republic	1
morphologically rich language	czech	1
neutral nation	czechoslovakia	1
north european country	czech republic	1
others language	czech	1
solid state detector	czt	3
strong nation	czechoslovakia	1
fabulous design	cz jewelry	1
national economy	czech republic	1
neighbouring nation	czech republic	1
post-communist country	czech republic	2
repressive country	czarist russia	1
staunch ally	czech republic	2
well-known airline	czech airlines	1
colored bead	czech glass bead	1
european donor	czech republic	1
non-eu state	czech republic	1
occupied country	czech republic	2
occupied country	czechoslovakia	1
technical exercise	czerny	1
accession country	czech republic	2
democratic government	czech republic	2
eastern european language	czech	2
eastern european language	czechoslovakian	1
eyeshadow shade	czar	1
formal exercise	czerny	1
industrialized economy	czech republic	1
modernized country	czechoslovakia	1
NATO state	czech republic	1
NMS	czech republic	1
non-euro country	czech republic	1
non-eurozone country	czech republic	1
semiconductor detector	czt detector	1
eastern european market	czech republic	5
EU accession country	czech republic	1
industrializing country	czech republic	1
introduction language	czech	2
non-slavic group	czechs	1
ocean color sensor	czcs	1
post-soviet state	czech republic	1
professional chef	czack at the cia	2
soviet bloc country	czech republic	3
stable economy	czech republic	1
affiliated society	czech republic	1
eastern block country	czech republic	3
folk craft	czech folk craft	1
high-tax state	czech republic	1
languges	czech	1
multiethnic society	czech republic	1
outcast	czeslaw milosz	1
satellite country	czechoslovakia	2
theinvolvementofsomeother actor	czech republic	1
affluent northern country	czech republic	1
central european economy	czech republic	2
central european economy	czechoslovakia	1
east european state	czech republic	1
ethnic dance	czardas	1
european union state	czech republic	1
key economy	czech republic	1
multi-ethnic state	czechoslovakia	1
event	czech village	1
polish city	czestochowa	1
soviet ally	czechoslovakia	2
continental european language	czech	5
ecological group	czech branch of friends of the earth	1
export-led economy	czech republic	1
heritage festival	czech	1
high-wage country	czech republic	1
independent promotion	czw	1
inflective language	czech	1
luckily many european developed nation	czech republic	1
metal processing	czochralski	1
post-communist state	czech republic	2
prestigious international music festival	czech republic	1
small and open economy	czech republic	1
small member state	czech republic	1
specialty blend	czar nicholas russian caravan	1
Synthetic stones	cz	1
typically eastern european country	czech republic	1
9mm	cz  seventy-five bd 	1
central and east european country	czech republic	1
crystal growth technique	czochralski method	1
defunct country	czechloslovakia	1
distinguished group	czech virtuosi orchestra	1
east-european country	czech republic	1
EU market	czech republic	1
international airway	czech airlines	1
international race	czech	2
international trade association	czech republic	1
multiethnic state	czechoslovakia	1
satellite state	czechoslovakia	2
soviet block country	czechoslovakia	1
substantial european minority	czechs	1
top-grade material	czech stones	1
visiting performer	czech conductor rafael kubelik	1
cash-strapped country	czechia	1
central europe country	czech republic	1
common medium	czapek	1
day state	czech republic	1
E.U. member	czech republic	1
eastern europe country	czech republic	2
economically strong country	czech republic	1
faceted stones	cz	1
high quality bead	czech glass	1
high quality bead	czech crystal	1
international nuclear waste generator	czech republic	1
mid-sized country	czech republic	1
pretty stones	cz	2
second tier team	czech republic	1
seemingly unconnected element	czech bead	1
slavic country	czech republic	2
Slavic peoples	czechs	2
small force	czech legion	1
successful nation	czech republic	1
successful reformer	czech republic	1
trade surplus country	czech republic	1
warsaw pact country	czechoslovakia	2
wonderfully exotic place	czech republic	1
advanced reformer	czech republic	1
capital account transaction	czech foreign direct investment	1
casual element	czech glass	1
central european state	czech republic	2
costume jewelry ring	cz women's ring	1
eastern bloc nation	czech republic	1
eastern europe market	czech republic	1
eastern european economy	czech republic	1
EU language	czech	1
eu-member country	czech republic	1
ex-soviet country	czech republic	1
fourth, country	czech republic	1
fourth, country	czech	1
key european market	czech republic	1
multilanguage environment	czech	1
non-preposition-stranding language	czech	2
post-socialist country	czech republic	1
semiconductor crystal	czt crystal	1
slavonic language	czech	1
accession state	czech republic	2
bold reformer	czech republic	1
catching-up country	czech republic	2
country organization	czech republic	1
czech company	czech radio-telecommunications	1
czech company	czech savings bank	1
eastern EU country	czech republic	1
eastern europe communist country	czechoslovakia	1
eastern european communist country	czechoslovakia	1
eastern european former communist country	czechoslovakia	1
emerging european country	czech republic	2
emerging european economy	czech republic	1
europen country	czech	2
geographic target market	czechoslovakia	1
happy offer high quality material	czech glass	1
harmonization	czech republic	1
leading european carrier	czech airlines	1
medium-costb-sugar producer	czech republic	1
menu language	czech	1
moped	czech-made jawa	1
morphologically complex language	czech	1
northern economy	czech republic	1
romanist state	czech republic	1
top quality bead	czech glass	1
advanced transition country	czech republic	2
australia line	cz	1
austria's european neighbor	czech republic	1
award successful side	czech republic	1
central eastern european country	czech republic	1
central european nation	czech republic	3
coming country	czech republic	1
cultural district	czech village	1
east european poet	czeslaw milosz	2
eastern and northern european country	czech republic	1
economically advanced state	czechoslovakia	1
equal country	czech republic	1
established eastern european market	czech republic	1
european foreign country	czech republic	1
ex-communist country	czechoslovakia	1
facing strong, established team	czech republic	1
fully sovereign country	czechoslovakia	1
high profile public figure	czech astronaut vladimir remek	1
home award	czech head	1
hotel association classification standard	czech republic	1
impressive architectural monument	czartoryski museum	1
key european country	czech republic	1
language edition	czech	1
large state-owned company	czech rail	1
loose diamond cut	czar cut	1
newest EU member state	czech republic	1
other institution	czechinvest other institution	1
prevalent case	czech republic	1
separation mode	cze	1
state-socialist country	czech republic	1
state-socialist country	czechoslovakia	1
top-flight football nation	czech republic	1
troubled european market	czech republic	1
warsaw pact nation	czechoslovakia	1
advanced transition economy	czech republic	2
austrian slavic minority	czechs	3
car plant	czech republic's skoda	1
CE technique	cze	2
central europe	czech republic	1
chinese and russian english-language periodical	czechoslovak life	1
classical central european country	czech republic	1
complete language	czech	1
crystal ornament	czech crystal	1
c-si growth method	czochralski	1
CZ jewelry	cz bracelet	4
czech group	czech union of freedom fighters	1
east european language	czech	1
east-bloc nation	czech republic	1
east-central european state	czech republic	1
eastern and central european country	czech republic	1
eastern central european country	czech republic	1
eastern-central european country	czech republic	1
economically mature country	czech republic	1
emerging markets	czech republic	1
organization	czech heritage societies	1
organization	czech insurance company	1
organization	czechoslovak genealogy society	1
ethnic peoples	czechs	1
export economy	czech republic's	1
gastronomic event	czceh beer festival	1
great feud	czw vs. roh	1
hard-to-find international fragrance	czech & speake	1
influential european power	czarist russia	1
iron curtain country	czechoslovakia	1
key eastern european location	czech republic	1
looted country	czechoslovakia	1
lower-cost destination	czech republic	1
mainstream european language	czech	1
multimillionaire property developer	czechoslovakian-born frank lowy	1
newly-industrialised and transition country	czech republic	1
non-coastal country	czech republic	1
postcommunist country	czech republic	1
organization	czech-north american chamber of commerce	1
organization	czm	1
organization	czech slovak benevolent society	1
organization	czech helsinki committee	1
organization	czech cultural centers	1
organization	czech army	1
postsocialist country	czech republic	1
post-socialist economy	czech republic	1
remarkable, eastern bloc country	czechoslovakia	1
rest eastern european state	czech republic	1
slav language	czech	1
slavic catholic nation	czech republic	1
slavic nation	czechs	1
small and open country	czech republic	1
socialist bloc country	czech republic	1
socialist or former communist country	czech republic	1
soviet past sharing country	czech republic	1
successful transition country	czech republic	1
thirty-five language	czech	1
war-affected european country	czechoslovakia	1
western FSU country	czech republic	1
world pilgrimage centre	czenstochowa	1
additionally country	czechoslovakia	1
advanced CEE market	czech republic	1
advanced reform country	czech republic	1
affluent eastern european country	czech republic	1
agglutinative or inflective language	czech	2
ambitious reformist neighbor	czech republic	1
ancient european nation	czechoslovakia	1
ascension state	czech republic	1
best ethnic dish	czech potato dumplings	1
border nation	czechoslovakia	1
communist-bloc country	czech republic	1
communist-dominated country	czechoslovakia	1
complex material process	czochralski crystal growth	1
conventional crystal growth technique	czochralski	1
currently overweight eastern european currency	czech koruna	1
czech language feature	czech alphabet	1
czech language feature	czech pronunciation rule	1
czech language feature	czech grammar	1
day piece	cz stackable ring	1
developed residential market	czech republic	1
disease-resistant type	czech variety topaz	1
earring style	cz silver lattice	1
eastern european dance	czardas	3
eastern european ethnic group	czechs	1
eastern retail market	czech republic	1
ECE country	czech republic	1
eurosensitive currency	czk	1
ex-soviet satellite state	czechoslovakia	1
extremely difficult piece	czardas	2
first reformer	czech republic	1
technique	cze	1
technique	cz pulling	1
high profile international team	czech republic	1
indirectly strengthened country	czech republic	1
international choral festival	czech republic	2
krakow's famous museum	czartoryski collection	1
local research organization	czech cartographic society	1
mature CE market	czech republic	1
medal favorite	czech republic	1
minor location	czech republic	1
multi-tier system	czech republic	1
NC language	czech	1
near-shore location	czechoslovakia for europe	1
non-low-cost airline	czech airlines	2
notable collector	czar alexander iii of russia	1
percussion player	czeslaw bartkowski	1
perfume bottle	czechoslovakian	1
polish poet	czeslaw milosz	2
post-communist european country	czech republic	1
pretty amazing brew	czech pils	1
pretty multicolored accent	czech glass button	1
prospective country	czech republic	1
prospective NATO nation	czech	1
quantity language	czech	1
richest CEE country	czech republic	1
seraph budget classic	cziffra's grieg & rachmaninoff concerto	1
slavic-speaking country	czech republic	1
slovenia's central european neighbor	czech republic	1
Small coun-tries	czech republic	1
small eastern european country	czech republic	1
small, over-armed state	czechoslovakia	1
southern and eastern european country	czech republic	1
spa guest	czech artist	1
state-trading country	czechoslovakia	1
strategically important ally	czech republic	1
subsuming state	czech republic	2
successful eastern european state	czech republic	1
successful postcommunist democracy	czech republic	1
targeted country	czech republic	1
top european orchestra	czech philharmonic	1
traditional israeli ally	czech republic	1
transformation economy	czech republic	1
unhistoric nation	czechs	1
unnecessary agency	czars	1
unusual european ski location	czech republic	1
victorious country	czechoslovakia	1
voucher program	czechoslovak	1
west slavic language	czech	1
17th century topographical view	czech w. hollar	1
acceding country	czech republic	2
accession MS	czech republic	1
advanced candidate	czech republic	1
advanced central european economy	czech republic	1
advanced fishing technique	czech nymphing	1
age-old rivalry	czech republic vs. slovakia	1
ambidextrous auto	cz  eighty-five  in  nine mm luger 	1
ambidextrous auto	cz  eighty-two  in  nine mm makarov 	1
applicant member	czech republic	1
awkward member state	czech republic	1
breakaway nation	czech republic	1
bur new country	czech republic	1
name	czechoslovakia	2
name	czeslaw milosz	1
name	cz baby	1
name	cz	1
CE mode	cze	1
CEE3 country	czech republic	1
CEES country	czech republic	2
central-eastern europeans country	czech republic	1
channeling style icon	cz guess	1
charismatic alternative leader	czechoslovakia's vaclav havel	1
classical sound	czecho-slovak radio symphony orchestra playing mascagni's intermezzo	1
collectible antique bottle	czech perfume bottle	1
comecon soviet controlled state	czechoslovakia	1
communist european country	czech republic	1
comparator economy	czech republic	1
core CEE market	czech republic	1
currently eastern european country	czech republic	1
czech beverage	czech beer	2
czech exporter	czech glassmakers	1
E.U. language	czech	1
east european member	czech republic	1
eastern and central european nation	czech republic	1
effective self-defense handgun	cz	1
EMEA currency	czeck koruna	1
emerging donor country	czech republic	1
emerging PV market	czech republic	1
eroupian star	czech forward josef vasicek	1
eroupian star	czech defenseman karel rachunek	1
espe-ciallythecasefor morpho-syntactically complex language	czech	1
established offshore location	czech republic	1
EU member-countries	czech republic	1
eu-acceding country	czech republic	1
european ascension state	czech republic	1
european union accession country	czech republic	1
expansion country	czech republic	1
fact very large corpora	czech national corpus	1
name	czech crystal	1
name	czech striker milan baros	1
fast growing central european country	czech republic	1
first-wave eu accession state	czech republic	1
fledgling EU member	czech republic	1
flexible and mature staffing market	czech republic	2
high decoration	czech state order of t. g. masaryk	1
high Z solid-state detector	czt	1
high-calibre team	czech republic	1
high-demand country	czech republic	3
human-led company	czerka enslaved entire nonhuman race	2
human-led company	czerka enslaved entire non-human race	1
hungary's regional partner	czech republic	1
imperial family member	czar's father	1
indigenous european curved sword form	czech tesak	3
institutional sport organization	czech soccer association	1
intellectual following	czech tomas halik	1
international movie film	czechoslovakian movies	1
landlocked transition economy	czech republic	1
letter c. market	czech republic	1
case	czech republic	17
case	czechoslovakia	6
case	czech developmental radar	1
man-made, factory-made or lab-made gem	cz	1
Maturing Marke ts	czech republic	1
meaty eastern european food	czech goulash	1
meniscus-defined growth system	czochralski	1
military surplus weapon	cz fifty-two 	1
mil-surp	cz- fifty-two 	1
mil-surp	cz- fifty 	1
modern bolt-action repeater	cz  five hundred and fifty 	1
mysterious, enchanting lake	czarna kuta	1
national line	czech	1
new-manufacture CZ	cz seventy-five 	1
non-eurozone member	czech republic	1
non-eurozone state	czech republic	1
Noteworthy Etherites	czar vargo	1
offer section	czars	1
old-style rogue	cziffra	1
popular western euro type	czs	1
case	czechia	1
case	czech	1
post-communist EU member	czech republic	1
professional AGRICULTURAL tour	czech agricultural tour	1
region's premier outsourcing destination	czech republic	1
room temperature semiconductor detector	czt	1
security-conscious state	czechoslovakia	1
slavic speaking country	czech republic	1
socialist satellite country	czechoslovakia	1
soviet dissident poet	czech dramatist	1
standard identification medium	czapek agar	1
strict NC language	czech	2
option	cz  two thousand and seventy-five  rami 	1
theoretically federal socialist state	czechoslovakia	1
top-notch service provider	czech vixen nikita denise	1
traditional sapphire growth technique	czochralski	1
unidirectional solidification method	czochralski crystal growth	1
unusual handicraft	czech puppet	1
well-known classical piece	czardas	1
Western Soviet peoples	czechs	1
wind energy developpers	czech cez	1
WWII weapon	czechoslovakian	1
year semiconductor detector	czt	2
advanced and beautiful country	czech republic	1
archaeological collection	czech national museum	1
ardent skeptic	czech president vaclav klaus	1
associate EU member	czech republic	1
Atypical transition economy	czech republic	1
avant-garde trend	czech poetism , expounded by k. teige	1
option	cz- seventy-five  compact 	1
option	czech air flying from prague	1
option	cz usa	1
big contest	czech nats	1
booth builder	czarnowski exhibit services	1
china-based white-box PC maker	czc technology	1
classic mauser action gun	cz	1
comparatively large market	czech republic	1
controlled cooling method	czochralski method	1
convenient melt-growth technique	czochralski method	1
conventional crystalline silicon technology	czochralski	1
country insector central europe	czech republic	1
Cubic zirconia jewelry	cz bangles shell bracelets cheap bead	1
culturally homogenous society	czech republic	1
culturally rich location	czech republic [www.czechtourism.com	1
CZ rifle	cz  five hundred and fifty  american 	1
E. europan country	czechoslovakia	1
eastern european animator	czechs jan svankmajer	1
east-european team	czechs	1
group	czechs	4
group	czechoslovakian	2
group	czech radio symphony	1
emerging european market currency	czech koruna	1
established equilibrium growth technique	czochralski	1
eu-accession county	czech republic	1
european immigrant group	czechs	1
example eastern european country	czech republic	1
fairly highly technologically advanced country	czechoslovakia	1
first plum	czar	1
first, charitable organization	czechoslovak red cross	1
flat tax country	czechia	1
folk observance	czech festival at wilber	1
forecasting institution	czech central bank	1
freer-word order language	czech	3
front runner state	czech	1
fundamentally solid country	czech republic	1
gavotte	czibulka's stephanie	1
harder-core leftist	czech communists	1
high-cap frame	cz- seventy-five 	1
hl mod	cz engine support hl mod	1
iancountries	czech republic	1
inexpensive country	czech republic	1
INTRODUCTION common method	czochralskior bridgeman	1
light pilsner	czechvar	1
lokomotiv player	czech-born jan marek	1
low defect density material	czochralski silicon	1
mature CEE market	czech republic	1
mature FDI host country	czech	1
mauser rifle	czech persian mauser	1
Mid Europeancountries	czech republic	1
milsurp pistol	cz- eighty-two 	1
mthinsideufessentires	czech crysting	1
newlv independent nation	czech republic	1
newly-formed country	czech republic	1
non-soi wafer	cz wafer	1
method	czochralski method	3
notable transfer	czech legend jaromir jagr	1
observing case	czechoslovakia	1
othor east european country	czechoslovakia	1
planned, centralized state	czarist russia	1
popular and traditional event	czechoslovakian evening	1
price point gun	cz	1
pro-libertarian leader	czechoslovakia's vaclav klaus	1
religious fraternal and benevolent organization	czech catholic union of texas	1
renowned human right advocate	czech president vaclav havel	1
respect well-advanced post-communist society	czech republic	1
room temperature semiconductor	czt	1
scammers native language	czech	1
scammer's native language	czech	1
method	czochralski	1
method	cze	1
method	czochralski pulling method	1
semiconductor ring	czt ring	1
serious classical concert	czech philharmonic	1
slavic luminary	czech scholar pavel safafik	1
slide model	cz seventy-five 	1
small film-producing nation	czech republic	1
speciality european lager	czech staropramen	1
standard spectroscope	czerney-turner spectroscope	2
sterling silver butterfly chain	cz celebrity jewelry butterfly necklace inspired by mariah	1
successful candidate country	czech republic	1
traditional Polish military headgear	czapka cap	1
uneducated and agrarian state	czechoslovakia	1
tool	czech processing tool	1
wavelength selective element	czerny-turner monochromator	1
World Santas	czechoslovakian father christmas	1
product	cz	4
project	czar suites	2
project	czech narration for elearning	1
project	czech republic's nase adresa	1
project	czech	1
artist	czars	1
artist	czech republic-born martina shapiro	1
material	czech glass	3
material	czech glass beads	2
material	czt	2
material	czech stones	1
material	cz diamond	1
material	cz stones	1
place	czech republic	18
place	czechoslovakia	1
player	czech republic's patrik berger	2
player	czech republic	2
player	czech tomas berdych	1
system	czech	1
product	czech amber	1
product	cz gemstone	1
product	cz engagement ring	1
product	czech beer related product	1
brand	cz	3
brand	czech juice brand	1
brand	czech export brand	1
brand	cz usa	1
brand	cz in the magazine	1
aspect	czechoslovakian secret police	1
related product	czech beer related product	1
