product	d&g sunglasses	1
resource	d&b professional contacts	1
resource	d&b	1
game	d&d online	3
game	d&d	2
game	d&d miniatures	1
game	d&d  three . one hundred and fourty-one 	1
game	d&d type game	1
subject	d&t	1
characteristic	d&g's chemical characteristic	1
client	d&b supply	1
client	d&g	1
product	d&o insurance	1
solution	d&b's e-business solution	1
book	d&d rule book	1
cost	d&o premium	1
favorite	d&b downs	1
expense	d&b report	1
policy	d&o policy	1
store	d&s falabella	1
customer	d&d maintenance	2
designer	d&g	1
report	d&b for underwriter	1
competitor	d&b software in atlanta andpeoplesoft in walnut creek	1
competitor	d&b software	1
line	d&o insurance for the financial service	1
line	d&g junior	1
top brand	d&g	1
shop	d&f models in glasgow harburn hobbies in edinburgh	1
prize	d&g bag	1
local organization	d&g council rangers	1
community organization	d&e counseling	1
local business	d&b tile	1
name brand	d&g wallet	1
online service	d&b business datum	1
trade	d&d miniatures	1
famous brand	d&g	2
contractor	d&e firm	1
distributor	d&h distributing	2
distributor	d&h distributing co.	1
monster	d&d specific monster	1
gallery	d&d studio	1
medical procedure	d&c	1
top designer	d&g	1
luxury brand	d&g	1
protection	d&o insurance	1
world	d&d campaign world	1
small company	d&h games	1
acronym	d&d	1
renowned company	d&g	1
expensive brand	d&g	1
hall	d&d hall	1
RPGs	d&d	1
key brand	d&g	1
industrial facility	d&s machinery	1
standard procedure	d&c with suction	1
handbag	d&g	3
handbag	d&g handbag at wholesale price	1
popular name brand	d&g wallet	2
home builder	d&w builders	1
chemical characteristic	d&g's chemical characteristic	1
designer item	d&g sunglasses	1
sunglasses	d&g sunglasses	1
designer frame	d&g women's sunglasses	1
external datum source	d&b family tree	2
upscale brand	d&g	1
jean	d&g	1
celebrites	d&v beckham	1
designer clothes	d&g	1
specialty line	d&o	1
company	d&b	1
company	d&h secheron electrodes limited	1
reduction	d&o insurance	1
furniture store	d&d home furnishings	1
signatory	d&r general contracting	1
credit agency	d&b	1
respected journal	d&b reports	1
risk issue	d&o liability	1
brand sunglasses	d&g	2
designer sunglasses	d&g sunglasses	1
t-shirt	d&g	1
type game	d&d type game	1
CLECs	d&e clec	1
e-business solution	d&b's e-business solution	1
designer perfume	d&g	6
brand handbag	d&g	1
non-routine operation	d&d operations in the presence of beryllium contamination	1
gaming product	d&d books	1
gaming product	d&d miniatures	1
information	d&b risk rating for advanced profiling	1
big fashion house	d&g	1
style brand new jean	d&g	1
labor-intensive activity	d&d work	1
branded designer sunglasses	d&g	1
event	d&ad sharpeners	1
brand sunglass	d&g	3
big consulting firm	d&t	1
underwear brand	d&g	1
AAA handbag	d&g handbag	1
fashion campaign	d&g ad	1
original branded watch	d&g	1
renowned label	d&g by dolce & gabbana	1
brand dress shirt	d&g	1
campaign world	d&d campaign world	1
original branded perfume	d&g	1
brand designer handbag	d&g handbags	1
clear and effcient department	d&r	1
designer replica	d&g	1
downhole device	d&m tool	1
wholesale branded handbag	d&g	1
designer & fashion jean	d&g	1
rep firm	d&r radio	1
sunglasses style	d&g	1
full system	d&d fat cat	1
sublines	d&o for companies in the financial sector	1
brand T-shirts	d&g	3
brand underpants	d&g	1
community agency partner	d&e staff	1
lore	d&d lore	1
compiled list	d&b	1
malt drink	d&g malta	1
original designer clothes	d&g	1
popular jamaican drink	d&g soft drinks	1
column pair	d&e	1
couture dress	d&g	1
designer perfume s	d&g	1
gucci sunglasses brand leader	d&amp g	1
high sensitivity phosphate kit	d&d rowa high sensitivity phosphate test kit	1
pelvic sugery	d&c	1
case	d&o coverage	1
Rulesets	d&d	1
tiffany bracelet brand leader	d&amp g	1
traditional account-level datum	d&b datum	1
uterus trauma	d&e	1
uterus trauma	d&c	1
claims-made policy	d&o policy	1
commercial grease cleanser	d&l hand cream	2
delicate product line	d&o	1
endometrial biopsy	d&c before the surgery	1
hard-to-find liability coverage	d&o for nonprofit	1
large restaurant company	d&d london	1
licence name	d&g time	1
local harley-davidson dealer	d&d buckman in dayton	2
low reality game	d&d	1
third party debt collection agency	d&b debt collection agency	1
traditional F2P game	d&d online	1
tool	d&c quantities	2
place	d&js in the fife area	1
player	d&d restaurant	1
product	d&o	1
product	d&b's commercial credit scores	1
brand	d&g	7
brand	d&g sunglasses	2
brand	d&g junior	1
