source	dg agriculture	1
property	dgn elevation	1
model	dgp andf model	1
model	dgp braneworld model	1
institution	dg vaishnav college	1
institution	dg jls	1
client	dgm	1
product	dgo	1
approach	dgt	1
agency	dgs	3
agency	dgh	1
agency	dgce	1
object	dgw dialog object	1
solution	dgps	1
procedure	dghal & rar	1
criterion	dgn	1
job	dgemm	1
manufacturer	dga	1
publication	dga magazine	1
publication	dg e&i	1
study	dge	1
study	dginternal market	1
position	dg of national institute of mass communication	2
position	dg of the national security guards	1
equipment	dgps receiver	1
equipment	dg set	1
basic	dg & gch	3
team	dgk	1
entity	dgs	1
format	dgrin	1
format	dgn	1
vendor	dg	1
department	dg agriculture	2
department	dg internal market	2
protein	dgcr eight 	1
guest	dga director	1
issue	dg eight  conformity 	1
brand name	dg eyewear	1
addition	dg hard chrome exhaust	1
herb	dgl licorice	1
package	dgauss	1
algorithm	dgm	1
charge	dgtd	1
issue	dgt	1
local attraction	dgone sports	1
association	dglr	1
network	dgm	1
paper	dg reporter	1
factor	dg performance	1
director	dga film director	1
signal	dg ps x	1
substrate	dgla	1
international organization	dg jrc	1
advanced technique	dgp	2
right	dght to life	1
nutrient	dgl licorice	1
version	dg-ux	1
routine	dgemm	2
complex system	dgps	2
modern technology	dgps	1
foundation	dg murray trust	1
syndrome	dgs	1
comment	dgtuuh watch movies online shoxtce common	1
union	dga	1
sequence	dgr	1
chore	dg walking	1
battle	dg code blue	1
rare case	dg eac	1
rare case	dg entr	1
adverse condition	dgps loss	1
technology company	dg two l tech 	2
communication channel	dg mare stakeholder platform	1
prestigious award	dga	1
system information	dgps health status	1
molecular technique	dgge purification	1
acronym	dgcam	1
digital product	dgital camera	1
key datum	dg sets	1
terminal	dgp	1
national institution	dga	1
aftermarket part	dg baja series skid plate	1
aftermarket part	dg fat series nerf bar	1
collaborator	dg of nigerian film	1
service	dgl- four thousand three hundred  support dynamic ip service 	1
transfer	dgdg transfer	1
ETFs	dgp	1
film director	dga film director	1
popular brand name	dgk	1
regulatory authority	dgsnr in france	1
thermodynamic parameter	dg	3
workload	dgemm	1
uniform item	dg ball cap	1
control technology	dg	1
shirt	dgk	1
prime mover	dg isdrivenby prime mover	1
navigation system	dgps	1
topic	dgps enhancement technique	1
mover	dg isdrivenby prime mover	1
underground artist	dg  three hundred and seven 	1
debt collector	dg solicitors	1
audit	dgh	1
labor group	dgz centre	1
ancillary operation	dg set	1
ISP	dgoldsmith@xxxxx.net	1
travel cost	dgh	1
germany tv channel	dgf tv	1
traditional format	dgn	1
ip service	dgl- four thousand three hundred  support dynamic ip service 	1
company	dgg	1
response variable	dgge band	1
construction machinery	dg set	1
local foundation	dg murray trust	1
economic actor	dg ecfin	1
company	dgc	1
company	dg	1
dynamic model	dgm	1
language program	dg eac's multicultural business program	1
state statute	dgcl	2
tunings	dgdgbd	1
external reference	dgn	1
brand handbag	dg bag	1
certification standard	dgac	1
group leader	dg fastchannel	1
pcr-based technique	dgge profile	1
third party inspection agency	dg shipping	1
german bank	dg bank	1
senior level position	dgm - mis	1
senior level position	dgm - operations dgm - finance	1
information	dgs charge	1
competition authority	dg comp	1
competition authority	dg comp of the european commission	1
transport document	dgd	1
vector image	dgn	1
detailed investigation	dga	1
system-level issue	dgc	1
legacy format	dgn	2
sustainability standard	dgnb	1
fractionation technique	dgt	1
operating brand	dghl	1
event	dga award	1
bilateral donor agency	dgis	1
export document	dgn	1
indian agency	dgca involved in the investigation	1
Interveners	dgc	1
CAD format	dgn for microstation	1
high profile official	dg oca	1
online test	dga	1
analog switch	dg four hundred and fourty-four 	1
aviation authority	dgac	1
equipment maintenance activity	dg sets	1
external file type	dgn	1
industrial maintenance service	dg sets maintenance service	1
modern analytical speciation technique	dgt	2
narrowband filter	dgm optics npb	1
PPOs	dga	1
assisted datum	dgps correction	1
functional scale	dgi	1
local licensing authority	dgt	1
workspace component	dgnlibs	1
currently available datum collection system	dgps	1
DGs	dg sanco	1
DGs	dg infosoc	1
directorate general	dg agriculture	1
dsrna-binding protein	dgcr eight 	1
fancy skill	dg cells	1
pakistani cement manufacturer	dg khan	1
serving bihar IPS officer	dgp abhayanand	1
serving bihar IPS officer	dg ashok kumar gupta	1
serving bihar IPS officer	dg v narayanan	1
serving bihar IPS officer	dg u s dutt	1
organization	dgs & d	2
top local school	dgs	1
advanced -diagnostic technique	dga	1
brand new power plant equipment	dg sets	1
building rating scheme	dgnb in germany	1
organization	dgs	1
indy company	dgusa	1
cult organization	dgbdni society	1
DGKs	dgka	1
DGKs	dgkd	1
DGKs	dgkz	1
EC service	dgs agriculture	1
technique	dgge of dna profiles extracted from soil	1
invariably purchase agency	dgst	1
invariably purchase agency	dgos	1
invariably purchase agency	dgs&d	1
metagenomic community analysis molecular technique	dgge	1
mirna component	dgcr eight 	1
narrowband nebula filter	dgm optics npb filter	1
native CAD file format	dgn	1
passive sampler	dgt	1
ralgas-fllledseparators	dgfrs at dubna	1
smart energy technology	dg	1
spatial file	dgn	1
application	dgps	1
application	dgge	1
application	dg with low voltage input source	1
typical gray neural work model	dgrbf	1
vectorial file format	dgn	1
wedge specific shaft	dg spinner	1
ancient battle series	dg's battles of the ancient world	1
brand tee	dgk	1
command line interpreter	dg's cli	1
commission department	dg employment	2
commission department	dgsancoanddg justice	1
complex and cross-sectoral field	dgd	1
conventional sperm preparation technique	dgc	1
creative industry institution	dgtmb shop	1
device serial communication parameter	dgp unit id	1
drawing format	dgn	1
european commission service	dg-regional policy	1
grain-based coproducts	dg	1
interchangeable, plug-and-play sensor subsystem	dgx-m camera controller	1
memorable skit	dg's pulp fiction'' skit on the riot	1
mutation scanning method	dgge  thirty-three 	1
native CAD format	dgn for microstation	3
pd-specific complication	dge	1
renewable process fuel	dgs	1
thermo-dynamic parameter	dg	1
user selectable various timer	dg crank-pause time	1
user selectable various timer	dg cranking time	1
affiliation graph	dgg dataset	1
analog switch IC	dg two hundred and one  supplied by siliconix corp. 	1
augmented system	dgps	1
C-13 modern GPS development	dgps	1
cache oriented operation	dgemm	1
coastal and local augmentation system	dgps	1
Commission DGs	dg competition	1
compound consonant	dg in edge	1
contemporary minicomputer	dg nova	1
dynamic and functional test	dgi	3
emission calculator	dgas	1
global marketing stalwart	dgm	1
high accuracy GCP collection method	dgps corrected	1
group	dg sanco	1
land-based navigation system	dgps	1
large producer-wholesalers	dgb	1
M-13 modern GPS development	dgps	1
modified gravity theory	dgp	1
motor sailplane	dg- eight hundred and eight c 	1
multi-gate technology	dg	1
networked directorate	dgi	1
non-step method	dg method	1
off-line monitoring	dga	1
position reference system	dgps	2
promising analysis	dgt phosphorus test	1
purpose-made album software	dg foto art	1
real board	dgk	1
regulation outfit	dgac	1
method	dgps	1
method	dgt	1
su-cientformost normal application	dgc event	1
tag-based method	dge	2
project	dg bank building in berlin	1
material	dg	1
technology	dg	4
technology	dgps	1
parameter	dgform	1
system	dgps	3
device	dgt	1
brand	dg sunglasses	2
brand	dgk	1
concept	dg	1
