policy	e&o	1
feature	e& m leased line	1
advanced feature	e&m coding	1
department	e&t technical services	1
restaurant	e&o trading	1
retailer	e&s trading	1
report	e&o	1
charge	e&o coverage	1
employer	e&j gallo	1
account	e&g	1
circuit	e&m tie trunk	1
large corporation	e&j gallo of the united states	1
well-known company	e& j gallo	1
winery	e&j gallo	3
item	e&s	1
large firm	e&j gallo	1
network service	e&m	1
american company	e&j gallo winery	1
coverage	e&o for architect	1
high street brand	e&j gallo	1
topic	e&h tax on equipment	1
company	e&j gallo	1
wine label	e&j gallo	1
frontier	e&p in deep	1
IP protocol	e&mtdm protocol	1
california wine	e&j gallo	1
signalling system	e&msignalling method	1
signalling system	e&m signalling method	1
normal site	e&o hotel	2
grille	e&g classic q chrome grille	1
servicing key account	e&y	1
alternate analog protocol	e&m	1
big california winemaker	e&j gallo winery	1
external third-party evaluation	e&usa's irs audit	1
application	e&m trunk	1
BMPSI component	e&o	1
easily identifiable wine	e&j gallo	1
prime commercial property developer	e&o property development bhd	1
top management consulting firm	e&y	1
business-related test	e&o safety	1
container manufacturer	e&j gallo winery	1
life agent requirement	e&o insurance	1
metrication regulation shop	e&j mcdermott in market street	1
RC3000-15-16E&M card application	e&m trunk	1
brand	e&j gallo winery	1
