facility	ew wee	1
source	ewtn global catholic radio	1
source	ewers	1
source	ew	1
source	ewable energy source	1
exception	ewan mcgregor	1
character	ewoks	1
character	ewen mcgregor s	1
work	ew w ork new work	1
work	ewer	1
model	ewma model	1
word	ewe	2
word	ewedu	1
attraction	ewert water park	1
institution	ewaso nyiro south development authority	1
document	ewb-uk training funding guidelines	1
document	ewers field note	1
product	eworld & cyberdog	1
product	eweb extra patient center	1
person	ewe	1
approach	ewma	1
alternative	ewma	1
object	ewer	1
symptom	ewcm	1
writer	ewan mccoll	1
writer	ewan mcintosh	1
writer	ewald	1
feature	ewf	1
star	ewan mcgregor	9
star	ewan macgregor	1
star	ewan maccoll	1
film	ewen mcgregor's documentary	1
band	ewf	1
part	ewoks	1
title	eweek	1
scholar	ewa morawska	1
feature	ewsystemoff ers additional voice feature	1
feature	ewe neck	1
celebrity	ewan mcgregor	13
celebrity	ewen westie gilmour	2
celebrity	ewan macgregor	1
celebrity	ewan bremner	1
disease	ewing's sarcoma	6
disease	ewing's tumor	1
industry	ewart's weaving mill on the crumlin road	1
indicator	ewcm	1
instrument	ewi	1
publication	eweek	3
website	ewan fergus website	1
figure	ewald	1
unit	ewoks on endor	1
unit	ewok handler	1
unit	ew non-profit unit	1
leader	ewald von kliest	1
musician	ewan maccoll	1
mean	ew rod box	1
instance	ewing's sarcoma	1
song	ewgu si na chi	1
expert	ewen chia	1
researcher	ewing et al twenty-nine 	1
researcher	ewart oakeshott	1
researcher	ewing et al.	1
animal	ewe	2
big name	ewan mcgregor	2
big name	ewen chia	1
club	ewa villages golf course	1
market	ewr	1
section	ewain	1
actor	ewan mcgregor	11
magazine	eweek	1
asset	ewi	1
sign	ewcm	2
retailer	ewf modern	1
trait	ewe fertility	1
guest	ewan pearson	2
performer	ewan maccoll	1
key item	ewa beach economic	1
key item	ewen economic	1
great	ewan mcgregor	1
language	ewe	8
language	ewondo	1
language	ewokese	1
neighborhood	ewa gentry	1
producer	ewan pearson	1
luminary	ewan mcgregor	1
algorithm	ewald-based method	1
rule	ewdd	1
utility	ewe of oldenburg	1
university	ewha womans university	2
friend	ewan hooper	1
issue	ewtd	1
everything	ewe	1
service provider	eweb	1
key issue	ewc trade union expert	1
historian	ewa morawska	1
association	ewm	1
network	ewtn	1
station	ewrs in alaska	2
station	ewr	1
station	ewr for hp	1
singer	ewan maccoll	2
singer	ewa podles	1
theorist	ewald	2
fund	ewm	1
fund	ewing morris opportunities fund lp	1
sponsor	eweb	1
vegetable	ewedu	1
factor	ewe nutrition	2
factor	ewe age	1
factor	ewe condition	1
factor	ewc's information provision	1
factor	ewp market demand	1
local organization	ewing marion kauffman foundation	1
notable	ewan mcgregor	1
professional organization	ewb	1
professional organization	ewca	1
center	ewing	6
newspaper	ew york times	1
rider	ewald kluge	1
photographer	ewan spencer	1
worker	ewa beach resident adele tangjian	1
community group	ewing environmental commission	1
tribe	ewes	2
master	ewen chatfield	1
famous name	ewan mcgregor	1
route	ewr - hkg	1
route	ewr-icn	1
local group	ewomen network	1
airport	ewr	4
airport	ewr for continental	1
online resource	ew three dinfo mailing list 	1
lesion	ewing's sarcoma	1
diagnosis	ewing sarcoma	1
manager	ewhm-compliant window manager	1
manager	eweek corporate partner	1
ethnic group	ewe in ghana	1
DJs	ewan pearson	2
tumor	ewing's sarcoma	4
tumor	ewing sarcoma	3
tumor	ewing's	1
energy source	ewable energy source	1
picture	ewes watching shooting stars	1
motif	ewer	1
simple tool	ewido	1
champion	ewa	1
endangered species	ew rare and endangered species	1
foundation	ewing marion kauffman foundation	1
item	ewart property tax	1
item	ewa beach property tax	1
periodical	eweek	2
traditional dish	ewe's cheese	1
cheese	ewe's milk cheese	1
owner	ewing kauffman	1
fault	ewe neck	1
private organization	ewing marion kauffman foundation	1
item	ewing township property tax	1
item	ewer	1
cancer	ewing tumor	1
cancer	ewing's sarcoma	1
cancer	ewing sarcoma	1
physician	ewen cameron	4
great name	ewen chia	1
presenter	ewan clark of bigdna	1
environmental group	ewg	1
minority	ewenki	1
historic building	ewelme cottage	1
historic building	ewing presbyterian church	1
area	ewell	4
area	ewa beach	2
area	ew	2
area	ewa	2
heavy hitter	ewan pearson	1
small community	ewarton	1
traditional approach	ewma	1
controller	ewi	1
announcement	ewa government systems	1
key technology	ewdm driver	1
playwright	ewan maccoll	1
practical item	ewer	1
explorer	ewing young	2
area	ewing	1
surrounding area	ewell	1
cast member	ewan mcgreggor	1
marketer	ewen chia	1
famous celebrity	ewan mcgregor	2
hub	ewr sfo slc	1
local store	ewa pantry	2
free program	ewido	1
business model	ewh kits program	1
advanced method	ewma	1
medium source	eweek	1
public utility	eweb	1
a-list celebrity	ewan macgregor	1
famous actor	ewan mcgregor	1
matrix	ewe's milk	2
address	ew one  in the from address field 	1
malignancy	ewing sarcoma	1
tube	ewes	1
complex application	ew	1
utility company	eweb	1
ethnic minority	ewenke nationality	1
area business	ewing-based developer of oled technology	1
industry publication	eweek	4
castle	ewloe	1
guru	ewen chia	2
popular magazine	eweek	1
great actor	ewan mcgregor	2
great actor	ewen bremner	1
trade publication	eweek	1
private university	ewha	1
chart	ewma chart	2
follower	ewald	1
ETFs	ewj	3
ETFs	ewm	2
ETFs	ewz	2
ETFs	ewg	1
oldie	ewf	1
neoplasm	ewing sarcoma	2
neoplasm	ewing's sarcoma	1
patron	ewan mcgregor	2
mass	ewing sarcoma	1
grassroots organization	ewaso lions	1
Alien species	ewoks	1
solid tumor	ewing's sarcoma	1
service	eworcester wire	1
rapid	ewing's rapid	1
professional team	ewe baskets oldenburg	1
investment firm	ewing management	1
great scholar	ew bullinger	1
topic	ew attack potential	1
domestic item	ewer	2
antivirus program	ewido	1
renewable energy resource	eweb windpower	1
local language	ewe	1
recruiter	ewen chia	1
subtypes	ewing's sarcoma	1
mammalian species	ewoks	1
weekly	eweek	1
beautiful area	ewden valley	1
great friend	ewa	1
daily item	ewer	1
window manager	ewhm-compliant window manager	1
indigenous language	ewondo	1
large property	eweb site	1
top publication	eweek	1
animal name	ewe	1
excellent school	ew chittum for k- five 	1
mainstream store	ewtn	1
boy name	ewan	1
spyware program	ewido	1
african language	ewe	1
malignant lesion	ewing's tumor	1
company	ewe ag	1
company	ewings sugar estates company ltd.	1
company	ewaste center	1
company	eware ltd.	1
company	ewaste services	1
company	ewa	1
company	ewe tel	1
wingers	ewan stratton	1
large accessory	ewok village	1
national language	ewondo	1
young child	ewan	1
tribal language	ewe	1
company	ewatch	1
internet marketer	ewen chia	1
mainstream site	ew.com	1
control chart	ewma chart	1
control chart	ewma	1
established figure	ewan macgregor	1
prediction model	ewma	1
sanitary ware	ewc	1
sarcoma	ewing's sarcoma	8
natural language	ewokese	1
voice feature	ewsystemoff ers additional voice feature	1
liberal scholar	ewald	1
local utility	eweb	1
big provider	eworld	1
production trait	ewe prolificacy	1
payment gateway	eway	3
pioneer name	ewing	1
antispyware program	ewido	1
star war character	ewoks	1
econometric method	ews models average mpi of a similar country with a strong financial system	1
starring big name	ewan mcgregor	1
weird name	ewing	1
tumor entity	ewing tumor	1
bone tumor	ewing's sarcoma	2
bone tumor	ewings sarcoma	1
bone tumor	ewing sarcoma	1
sanitary fitting	ewc	1
year performer	ewan mcgregor	1
attractive village	ewelme	1
firmware	ewrt	1
good group	ewtn	1
high-speed Internet connection	ewol wireless	1
homogenous group	ewe	1
CPA network	ewa network	1
top internet marketer	ewen chia	1
information	ewings comassistant software installation	1
great clinician	ewald	1
news web site	eweek	1
trapper	ewing young	1
fantastical character	ewingerale the woodpecker scribe	1
malignant process	ewing's sarcoma	1
surname variant	ewde	1
classic team	ewing's knicks	1
exchange traded fund	ews for singapore	1
pediatric tumor	ewing's sarcoma	3
round cell tumor	ewing's sarcoma	1
round cell tumor	ewing sarcoma	1
west african language	ewe	1
common button	ewn	1
international professional association	ewf	1
reputable group	ewing marion kauffman foundation	1
sanitary ware product	ewc suite plus	1
seasonal breeder	ewe	1
famous mountain man	ewing young	1
hot, dry area	ewa plain	1
notable effort	ewtn	1
popular hawaii city	ewa beach	2
volatility model	ewma	1
celtic name	ewan	3
korean university	ewha women's university	1
minifigures	ewok s	1
online payment processor	ewalletexpress	1
scottish actor	ewan mcgregor	1
small round cell tumor	ewing sarcoma	1
small round cell tumor	ewing's sarcoma	1
Aggressive weed species	ewm	1
bone cancer	ewing's sarcoma	2
bone sarcoma	ewing's sarcoma	11
bone sarcoma	ewing sarcoma	3
california-based promotion	ewf	4
casino deposit method	ewalletxpress	1
chalk river	ewelme brook	1
common domestic animal	ewe	1
program	ewido	2
program	eworkforce management	1
nonpartisan race	eweb	1
superb actor	ewan mcgregor	1
traditional control chart	ewma	1
ceramic ware	ewc	1
family food	ewedu	3
health economist	ewe reinhardt	1
home area	ewa beach	1
malignant bone tumor	ewing's sarcoma	4
narrow lane	ewing place	1
online scan	ewido	1
ornate object	ewer	1
famous secondary school	ewu grammar school	1
community	ewing township	5
community	ewing cdp	2
community	ewing city	2
community	ewing village	2
community	ewoldt township	1
community	ewa gentry cdp	1
community	eworld	1
community	ewa villages cdp	1
multivariate control chart	ewma	1
others study	ewm	1
regional gallery	ewing at melbourne university	1
body's own sign	ewcm	1
compass feature	ew-ns adjustment rod	1
conformation fault	ewe neck	2
community	ewing ccd	1
community	ewington township	1
community	ewa beach cdp	1
community	ewa ccd	1
engineering substantiation report	ewis	1
frontier officer	ewell otis	1
ghanaian language	ewe	4
Granular info	ewt	1
mesenchymal malignancy	ewing's sarcoma	2
ovulation symptom	ewcm	1
organization	ewtn	2
spokane-area program	ewu's center for entrepreneurial activities	1
advanced chart	ewma	2
aggressive process	ewing's sarcoma	1
american fur trapper	ewing young	1
big library	ewql gold xp	1
organization	ewi	1
organization	ewa weed & seed	1
organization	ewb	1
organization	ewalution coalition for drug free hawaii	1
GR shipment datum	ewc code	1
internet magazine	eweek	2
mainstream irrigation distributor	ewing irrigation	1
national on-line service	eworld	1
patrilineal group	ewe	2
pseudo language	ewok	1
sentient species	ewoks	1
virtual directory	ews	1
well-known New Zealanders	ewen gilmour	2
windowed element	ewebeditpro control	1
advanced signal processing application	ew	1
african drum	ewe drum	1
technique	ewald sum	1
technique	ewald summation	1
technique	ew	1
bone neoplasm	ewing sarcoma	2
complimentary information technology magazine	eweek	1
conventional scanner	ewido	1
freight train company	ews railway	1
high capacity domestic route	ewr-iah	1
high-grade lesion	ewing's sarcoma	1
kit-positive tumor	ewing sarcoma	2
kwa language	ewe	1
large lesion	ewing's sarcoma	1
luncheon	ewr	1
native character	ewoks	1
native scots actor	ewan macgregor	1
notable adventurer	ewing young	1
passive and active defense measure	ew	1
political composer	ewan maccoll	1
popular website building tool	ewisoft website builder	1
professional library	ewqlso	1
real, legitimate online business professional	ewen chia	1
renowned KUKA roboter partner	ewm	1
seasoned former senior XV player	ewan cowie	1
small round-cell tumor	ewing's sarcoma	1
application	ew system	1
technology switch	ewsd	3
telnet program	ewan telnet	1
traditional residual based chart	ewma on the residual	1
unexpected connection	ewok's u-clip theory	1
univariate control chart	ewma chart	1
vision scientist	ewald hering	1
aberdeenshire maker	ewen	1
adversary fixed EW site	ew support	1
affiliate guru	ewen chia	1
aggressive malignancy	ewing's sarcoma	2
air force directive	ew test	1
anti spyware removal program	ewido	1
background building large content site	ew.com	2
breeding stock	ewe lamb	2
broad band system application	ew system	2
name	ewan mcgregor	7
name	ewald kluge	1
name	ewa lachnit	1
name	ewell	1
name	ewin chia	1
name	ewok trail	1
childhood bone cancer	ewing's sarcoma	2
childhood solid tumor	ewing sarcoma	2
childhood solid tumor	ewing's sarcoma	2
complicated chart	ewma	1
discontinued product	ewqlso sound set	1
expensive negation measure	ew	1
first-hand, successful owner	ewing kauffman	3
forlarger VTOL aircraft	ewr vj- one hundred and one 	1
free site-building software program	ewisoft builder	1
gateway provider	eway without an online merchant account	1
gbe language	ewe	1
high-ranking institution	ewha women's	1
infinite summation method	ewald summation	1
international ETFs	ewg	1
large and deep sampling library	ewqlso platinum	1
case	ewing	1
localized language	ewokese	2
longer-term contract	eweb-seneca contract	1
low noise receiving antennas	ewes	1
malware detection program	ewido	1
microwave subsystem	ew simulation system	2
model specific method	ewma	1
orthodox resource	ewtn	1
paediatric sarcoma	ewing sarcoma	1
private advocacy group	ewg	1
private mission school	ewha women's university	1
protestant missionary institution	ewha school	1
remix compilation	ewan pearson's piecework	1
research organization organisations	ewater cooperative research centre	1
short day breeder	ewe	1
Slot-2 slolutions	ewin two 	1
small cell malignancy	ewing's sarcoma	1
southern language	ewe	1
spin-on organic material	ewlb organic wafer material	1
textbook filter method	ewma filter	1
top affiliate marketer	ewen chia	1
top quality bathroom suite	ewc	1
traditional SPC control chart	ewma chart	1
transcon market	ewr	1
virtual instrument pack	ewqlso gold	1
wartime field	ewa	1
well-groomed star	ewan mcgregor	1
well-meaning organization	ewg	1
well-travelled star	ewan mcgregor involved	1
wind controller	ewi	1
yongle period ceramic vessel	ewer in the topkapi saray museum	1
activist exposure study	ewg body burden project	1
aspiring gaming tribe	ewiiaapaayp in east county	1
broad-minded and visionary individual	ewc alumnus	1
Canadian ETF	ewc	1
catholic TV channel	ewtn	1
central provision	ewr	1
commercial grazing company	ewe four ic ecological services 	1
committee officer	ewa	1
complicated, big-money, multiyear contract	ewing's six-year	1
consumer advocate newsletter	ewg	1
contemporary electronic whiz-kid producer	ewan pearson	1
continued airworthiness issue	ewis maintenance	1
conventional positioning scheme	ewm	1
countable weapon platform	ew	1
defense-unique design	ew signal processor	1
diaphyseal tumor	ewings sarcoma	1
dynamic catholic speaker	ewtn host fr	1
group	ewenkis	1
group	ewg	1
efficient electrostatic lattice sum method	ewaldand particle-mesh ewald	1
embedded-specific component	ewf	1
eminent german psychiatrist	ewald	2
ewalletxpress online gambling site	ewalletxpress casinos	1
EWH program	ewh design competition	1
Experienced seamers	ewen thompson	1
first haplotype test	ewens-watterson homozygosity test	1
flagship output	ewcs report	1
folk enthusiast	ewan maccoll	1
good anti-malware application	ewido	1
gravity-type core	ewing corer	1
HOF center	ewing	1
ine-health service	ews application	1
group	ewe	1
informational infrastructure	ewg.org in making the public aware of toxic chemicals in cosmetic	1
international wind trade fair	ewec in marseille	5
irrigation supply house	ewing	1
KDE service	ewalk tool	1
learning technolo gies	ewb	1
legacy kompakt library	ewqlso	1
mercial grazing company	ewe four ic ecological services 	1
metastatic bone cancer	ewing's sarcoma	1
milwaukee auto dealership	ewald auto group	1
miriad-based application	ewb	1
modern switching system	ewsd	1
new work	ew w ork new work	1
non-cns malignancy	ewing sarcoma	1
non-destructive activity	ew mission	1
non-kabiye name	ewe day name	1
method	ewm	1
note European ETFs	ewn	1
not-for profit operation	ewtn	1
Obas	ewuare the great	1
online monitoring service	ewatch	1
online scanning	ewido	1
patrilineages	ewes	1
polychrome painted figure	ewers in the form of a monkey	1
popular short	ewetopia short	1
prince william's fan	ewa pandjaitan	1
quality packet modem	ewave radio modem	1
rare yongle vessel	ewer in topkapi saray	2
religious and inspirational network	ewtn	1
scots celebrity	ewan mcgregor	1
site dev platform	ew	1
small round cell sarcoma	ewing sarcoma	2
small-cell malignant tumor	ewing's sarcoma	1
so-called orphan disease	ewing's	3
sourcing agency	ewatch	1
sprinkler supply house	ewing	1
star war costume	ewok	1
translocation-derived sarcoma	ewing sarcoma	1
treatment system specific	ew location	1
two-seat system	ewr	1
U.L. installation	ewas installation	1
tool	ew	1
well-known computational technique	ewald summation	1
widely-available outlet	ewtn	1
project	ewa pointe shopping center	1
project	ewingsdale interchange	1
project	ewarton watershed farmers cooperative society	1
artist	ewan mcgregor	3
artist	ewing family stone	1
artist	ewan maccoll	1
artist	ewf	1
artist	ewan uglow	1
place	ewen	1
place	ewing irrigation	1
player	ewen mckenzie	1
technology	ewf nt loader	1
parameter	ew in emission	1
parameter	ewma constant	1
system	ewc ultrazone	1
species	ewe	2
species	ewm	1
species	ew rare and endangered species	1
measure	ewi	1
element	ew element	1
element	ew	1
product	eweb extra tm patient center	1
variable	ewo operator technique	1
function	ew system integration	1
site	ewenny	1
