accessory	fj cruiser performance accessory	1
word	fjord	1
object	fjd svinesund	1
location	fjords of norway	1
location	fj's fuse block	1
writer	fjodor mihailovic dostojevski	1
part	fjalms of the hand	1
website	fj	1
feature	fjord	1
vehicle	fj land cruisers from the  sixty s 	1
restaurant	fj bistro	1
retailer	fj benjamin holdings ltd.	1
machine	fjs	1
pattern	fjob sharing	1
car	fj cruiser	2
scientist	fjeld	1
shop	fjording	2
breed	fjords	3
engine	fjr one thousand three hundred 	1
power	fjortisar amazing power	1
variant	fj-like virus	1
complex system	fjord	1
performance accessory	fj cruiser performance accessory	1
formation	fjord	1
spec	fj cruiser	1
coastal area	fjord	1
bike	fjr's	2
area	fjords in southern chile	1
natural wonder	fjord	1
social scientist	fjordman	1
beautiful beach	fjord of furore	1
building product	fj raw	1
building product	fj primed	1
winter activity	fjord fishing	1
estuary	fjord	1
SUVs	fj	1
clothing store	fjallraven	1
penetration	fj	1
coastal feature	fjord	2
company	fj benjamin	2
horse breed	fjord horse	7
glacial feature	fjord	1
natural formation	fjord	1
pony	fjords	1
company	fj	1
toyota model	fj cruiser	2
toyota vehicle	fj cruiser	1
activity	fjord cruise	1
sheltered location	fjord	1
discount shop	fj's	1
print publisher	fjh	1
toyota new model	fj cruiser	1
toyota's new model	fj cruiser	1
enclosed water	fjords	1
amazing power	fjortisar amazing power	1
dinghy	fj	1
subsidiary brand	fj jones	1
brand new LHD car	fj cruiser	1
exciting itinerary	fjords	2
fjord	fjaerland	1
factor	fjord depth	1
niche vehicle	fj cruiser	1
stunning natural wonder	fjord	1
common landscape feature	fjord	1
big sport bike	fjs	1
distributing brand	fjords	1
down-under movie classic	fj holden	1
fjallraven jacket	fjallraven telemark	1
fjallraven jacket	fjallraven montt	1
fjallraven jacket	fjallraven nordli	1
jet type	fj- four  fury in the light attack role 	1
jet type	fj- four  ful'y in the light 	1
mid-size sport utility vehicle	fj cruiser	1
print-editions	fjords	1
restored cold war-era jet fighter	fj four  fury 	1
semi-enclosed coastal system	fjord	1
theater institution	fjernsynsteatret	1
AA partner	fj via nadi	1
archetypal aquatic ecosystem	fjord	2
extremely neritic location	fjord	1
nameable player	fj dickhut	1
case	fj bloemen	1
scandinavian ferry company	fjordline stena line	1
semi-enclosed coastal area	fjord	1
speciation model	fjeldsa's montane speciation model	1
well-defined linear feature	fjord	1
work-oriented method	fja	1
cruise classic	fjords of norway	1
deep-water estuary	fjord	1
landslide territory	fjord region	1
modern machinery space	fjord norway's engine room	1
well-established and renowned subsidiary	fja feilmeier & junker gmbh	1
yamaha sport bike model	fjr one thousand three hundred 	1
place	fjl one  on twitter 	1
player	fj smith	1
brand	fjc	5
concept	fjord	1
concept	fjord fisher	1
component	fjord-side fan	1
