institution	g&f financial group	1
role	g&t coordinator	1
series	g&p	1
supplier	g&s dye in toronto	1
medical facility	g&g holistic drug rehab	1
firm characteristic	g&a expense	1
grower	g&b orchid labs	1
unknown	g&t	1
refiner	g&s metals	1
company	g&j pepsi-cola bottlers inc.	2
company	g&t conveyor	2
company	g&g specialties	1
foundry	g&w foundry	1
focus group	g&t	1
company	g&k automotive conversion inc. in santa ana	1
company	g&a ferry	1
classical theorist	g&eacute;rard genette	1
company	g&e grocery	1
company	g&j pepsi-cola bottlers	1
high quality	g&p over systema	1
land-based economic activity	g&athering conducted on reservation	1
paint scheme	g&d over the year	1
large-scale datum set	g&g datum	1
additive cost	g&a expense	1
Pneumatic blowback	g&g blowback ak	1
Pneumatic blowback	g&g combat machine m four 	1
UICC manufacturer	g&d	1
ability etc	g&t	1
Airsoft M-series	g&p	1
arch wire manufacturer	g&h wire	1
bogus medical company	g&y orthopedic shoes	1
high quality clone's	g&g	1
Lakelands	g&h kendal flake	1
large brickwork contractor	g&h contractors ltd on george wimpey site	1
local computer dealer	g&s computer services	1
market tuner	g&d automotive	1
melb sponsor	g&d	1
U.S. plant	g&c packing	1
brand name piston	g&p through stripping	1
huge cup size	g&h cup size	1
ongoing educational and training program	g&a university	1
reservoir modeling-related datum	g&g datum	1
brand	g&g	1
