product	g-combo converter plus	1
product	g- seventy-one  graber vertical blinds 	1
initiative	g- twenty 's sme finance challenge 	1
initiative	g-jordan days	1
accessory	g-strings	2
accessory	g-shock watch	1
game	g-police	1
game	g-loc	1
subject	g-forces	1
product	g-technology	1
exception	g-minor gamba sonata	1
character	g-man bart	1
work	g-major viola concerto by johann stamitz	1
model	g-class	4
model	g-force super pool slide	1
model	g-wiz	1
model	g-furys	1
characteristic	g-banding pattern	1
word	g-string	1
word	g-d	1
skill	g-tub care	1
category	g-actin-binding protein	1
feature	g-sensor	4
approach	g-estimation algorithm	1
feature	g-code generation	2
book	g-d's new day	1
star	g-type giant star	1
film	g-force	2
procedure	g-spot injections	1
procedure	g-banding	1
agent	g-csf	2
feature	g-rated animated feature	1
venue	g-a-y	1
venue	g- eight  summit 	1
venue	g-land	1
firm	g-mills	1
drug	g-csf	10
drug	g-hydroxybutyric acid	1
test	g-test	2
manufacturer	g-force racing gear	1
manufacturer	g-tech	1
manufacturer	g-technology	1
act	g-love & special sauce	1
act	g- five  clive 	1
setting	g- eight 	1
position	g-spot friendly sex position	1
musician	g-love	2
movie	g-force	3
movie	g-men from hell	2
innovation	g-con	1
entity	g- eight 	2
country	g- twenty 	1
feature	g-mail	1
feature	g-force monitoring	1
improvement	g-type compressor	1
concern	g-forces	1
piece	g-plan	1
show	g-gundam	2
role	g-force	2
sector	g- thirteen 	1
influence	g-love	1
vehicle	g- seven  commercial vehicle 	1
section	g- seven 	1
actor	g- thirty-three  group of developing country 	1
label	g-star raw	1
designer	g-star	2
award	g-mark good design award	1
article	g-code for manual machinist	1
module	g-sensor gravity detecting device	1
provider	g-mail	1
report	g- ten  survey 	1
party	g- seventeen 	1
protein	g-proteins	7
protein	g-csf	2
protein	g-gamma subunits of g-protein coupled receptor	2
protein	g-gamma subunits of heterotrimeric g-proteins of the g-protein coupled receptor	2
protein	g-protein coupled chemokine receptor cxcr four 	1
protein	g-protein-coupled receptor	1
protein	g-quadruplex binding protein	1
protein	g-protein couples receptor	1
protein	g-protein alpha subunits	1
issue	g-function analysis	2
issue	g- twenty 	1
goal	g- four 	1
brand name	g-unit	1
brand name	g-plan	1
brand name	g-star	1
weapon	g- thirty-six  c 	1
weapon	g- thirty-six 	1
language	g-code into the signal	1
line	g-star	1
producer	g-p	1
car	g-wiz	2
car	g-jet	1
platform	g- eight  summit 	1
top brand	g-star	2
top brand	g-star raw	1
top brand	g-unit	1
molecule	g-proteins	2
molecule	g-protein effector molecule	1
molecule	g-protein-coupled receptor	1
molecule	g-protein-regulated effectors	1
molecule	g-alpha subunits of heterotrimeric g protein	1
result	g-c-a-f-type magnetic transition with electron doping	1
sensor	g-sensor	4
mode	g-tor	2
shop	g-girls surf	1
ability	g-power swap	2
guy	g-sot	1
supplement	g-whiz neutralizer	2
annual event	g- eight  summit 	1
NGOs	g- seventeen  institute 	1
NGOs	g- seventeen 	1
forum	g- twenty 	13
forum	g- eight 	4
forum	g- seven 	1
forum	g- eight  moribund 	1
forum	g- twenty  meeting 	1
signal	g-off signal	1
notion	g-subsheaves	1
prop	g-strings	2
genre	g-funk	1
response	g-protein activation	1
international organization	g- eight 	2
international organization	g- twenty 	1
stimulus	g-protein coupled receptor agonists	1
power	g-d	1
interest group	g-force	3
gadget	g- three  multipurpose communication gadget 	1
trade	g-shock watch	1
software program	g-lock into finnish from english	1
volunteer	g-lish staff	1
entry	g-spot	1
manager	g- three 	1
manager	g- four 	1
famous brand	g-star	1
local artist	g-steele	1
light source	g-ray mercury-vapor lamp	1
artiste	g-whizz	1
dance	g-slide	1
international brand	g-star	1
radio station	g-fm in middleburg	1
minor change	g- ten  scale 	1
phase	g- one 	1
nickname	g-force	1
big brand	g-star	1
stat	g-force	1
great brand	g-star jeans	1
item	g-strings	1
growth factor	g-csf	23
growth factor	g-csf gm-csf	1
growth factor	g-csf g-csf granulocyte colony-stimulating factor	1
rapper	g-dragon	2
rapper	g-unit	1
safety issue	g-forces	1
rock	g- two 	1
designer brand	g-shock watch	1
international event	g- twenty  seoul summit in november 	1
treatment modalities	g-csf	1
receptor	g-protein-coupled receptor	3
receptor	g-protein coupled receptor	1
cytokines	g-csf	33
small molecule	g-amino-butyric acid	1
lens	g-clarons apochromatic process lenses of the same focal length	1
porous material	g- ten  circuit board 	1
key	g-sharp key	1
famous musician	g-love	1
clothing	g-strings	1
assay	g-banding	1
synthetic material	g- ten 	2
pathway	g-protein signaling	1
formulation	g- four hundred and eighteen  sulfate 	1
gathering	g- eight  meeting 	1
agonists	g-protein receptor agonists	1
agonists	g-protein receptor-coupled agonists	1
grouping	g- twenty  highlight cooperation between developed 	1
strain	g- thirteen 	3
strain	g- six 	1
area	g- ten  impact area 	1
implementation	g-portal system	1
drive	g-tech g-drive	1
medical supply	g-tube feeding supply	1
american artist	g-unit	1
fan favorite	g-switch mobile	1
therapeutic agent	g-csf	2
cocktail	g-force	1
international institution	g- twenty 	2
international institution	g- eight 	1
international institution	g- seven 	1
world event	g- eight  meeting in edinburgh 	1
established brand	g- two thousand  	2
attendee	g-shock	1
record label	g-series	1
composite material	g- ten 	2
composite material	g- ten  phenolic 	1
established name	g-star	1
area	g- fifteen 	1
great act	g-love & the special sauce	1
international group	g- twenty 	2
international group	g- seven 	2
international group	g- twenty-two 	1
international group	g- eight 	1
medical intervention	g-tube feeding	1
fashion brand	g-star	1
exclusive brand	g-unit	1
clothing brand	g-unit	3
rare condition	g-cell hyperplasia	1
national artist	g-unit	3
service	g-cash in the philippines	2
service	g-mail	2
alliance	g- thirteen 	1
alliance	g- eight 	1
commercial vehicle	g- seven  commercial vehicle 	1
prestigious brand	g-star	1
international initiative	g- eight 's digital opportunity task force 	1
vital statistic	g-forces	4
inflammatory mediator	g-csf	1
stocking brand	g-star	1
developing country	g- thirty-three 	1
core product	g-talk	1
core product	g-mail	1
electric vehicle	g-wiz electric car	1
membrane protein	g-protein coupled receptor	5
membrane protein	g-protein-coupled receptor	2
synthetic	g- ten 	2
coalition	g- twenty 	2
coalition	g- eight 	1
coalition	g- thirty-three 	1
small car	g-wiz	1
clothing line	g-unit	1
notable act	g-love	1
pen	g- two 	1
amplifier	g-k	1
primer	g- ten 	1
core technology	g-trac true-tracking technology	1
hill	g-reen hill	1
international forum	g- twenty 	3
international forum	g- eight 	2
international forum	g- eight  meeting 	1
medical need	g-tube feeding	1
NPCs	g-man	1
adsorbent	g- one hundred and thirty-two d 	1
adsorbent	g- seventy-two d 	1
multilateral organization	g- twenty 	2
sex toy	g-spot dildos	1
sex toy	g-spot tickler	1
global institution	g- twenty 	1
inspection	g- twenty-three  special inspection special inspection 	1
inspection	g- twenty-four  special inspection special inspection 	1
institutional structure	g- ten 	1
private sector	g-psf working group on manufacturing	1
topic	g-proteins	1
Proinflammatory cytokines	g-csf	1
informal group	g- eight 	1
informal group	g- twenty 	1
Inflammatory cytokines	g-csf	1
Modern aircraft	g-v	1
stock brand	g-star	1
electric car	g-wiz	9
e-mail program	g-mail	1
international and regional organization	g- eight  nations 	1
receptor agonists	g-protein receptor agonists	1
high-income country	g- seven 	2
international meeting	g- seven 	1
company	g-star	2
company	g-slot entertainment	1
company	g-force stunt team	1
company	g-i holdings inc.	1
easy-to-use feature	g-sensor	1
functional category	g-protein-coupled signaling	1
summit	g- twenty 	2
regional grouping	g- eight 	1
regional grouping	g- seventy-seven 	1
stimulation	g-spot stimulation	1
binding protein	g-quadruplex binding protein	1
multilateral forum	g- eight 	2
transmembrane protein	g-protein-coupled receptor	2
extracellular stimulus	g-protein-coupled receptor	1
focus group	g- seventy-seven 	1
cross section	g-g of fig	1
company	g-unit records	1
brand store	g-star raw	2
evaluation measure	g-mean	1
award program	g-i's numerous award program	1
gene family	g-protein-coupled receptor	1
Immunomodulators	g-csf	1
java feature	g-mail	1
hot brand	g-star	1
signalling molecule	g-proteins	1
online shopping site	g-market	1
denim brand	g-star	1
extracellular signal	g-protein-coupled receptor agonists	1
company	g-unit clothing	1
separate program	g-mail	1
stocking label	g-star	1
adult toy	g-spot vibes	2
animated feature	g-rated animated feature	1
laboratory marker	g-glutamyl transferase	1
multilateral initiative	g- eight  global partnership against the spread of weapons 	1
multilateral initiative	g- eight  global partnership against the spread of weapon s 	1
global actor	g- twenty 	1
online account	g-mail	1
cult brand	g-star	2
intimate item	g-strings	1
big piece	g-minor ballade	1
global approach	g-theta method	1
complex protein	g-protein coupled receptor	2
global forum	g- twenty 	5
global forum	g- thirty-three 	1
global forum	g- twenty-two 	1
integral membrane protein	g-protein coupled receptor	1
traditional alternative	g- seven 	1
Casual wear	g-star	1
colored diamond	g-i diamond	1
effector molecule	g-protein effector molecule	1
immune modulator	g-csf	3
signaling component	g-protein-coupled receptor system	2
signaling component	g-proteins	1
e-mail provider	g-mail	1
landscape -metric	g-g	1
e-mail account	g-mail	1
biological response modifier	g-csf	1
biologic response modifier	g-csf	1
lens color	g- fifteen 	1
regional and international organization	g- eight 	1
drug target	g-protein coupled receptor	1
molecular target	g-protein coupled receptor	2
OEM company	g-tech optoelectronics	1
colony-stimulating factor	g-csf	22
hematopoietic growth factor	g-csf	22
international committee	g-l zero 	1
scaffolding material	g-clamp	1
communication gadget	g- three  multipurpose communication gadget 	1
immunostimulants	g-csf	1
western donor	g- seven  government 	1
western donor	g- eight 	1
real world event	g- eight  summit at sea island 	1
style brand new jean	g-star	1
top designer label	g-star	1
brand name jean	g-star	2
country group	g- thirty-three 	1
EVs	g-wiz	1
independent manufacturer	g-tech	1
institutional framework	g- seven 	2
colony stimulating factor	g-csf	7
idol star	g-dragon	1
industrial power	g- eight  country 	1
Hematopoietic cytokines	g-csf	4
inhibitory neurotransmitter	g-aminobutyric acid	1
expensive camera	g-series	1
gangsta rapper	g-unit	1
sofa	g-plan	1
information	g-node information	1
staff representative	g- six 	1
staff representative	g- four 	1
staff representative	g- five 	1
staff representative	g- one 	1
staff representative	g- two 	1
staff representative	g- three 	1
system controller	g- fifty 	1
webmail account	g-mail	1
free e-mail account	g-mail	1
monokines	g-csf	2
signal transduction molecule	g-protein-coupled receptor	1
subsidiary group	g-wiz	1
subsidiary group	g-style	1
subsidiary group	g-force	1
company's model	g-class	1
contemporary font foundry	g-type	1
high energy radiation	g-rays	1
prison gang	g- twenty-five 	1
sex position	g-spot friendly sex position	1
exclusive boutique	g-star	1
hematopoietic factor	g-csf	2
mercedes-benz collection	g-class	1
non-immigrants	g- four  dependents of diplomatic visa holder 	1
reputable name brand	g-iii sports	1
BRMs	g-csf	1
event	g- eight  summit in july 	1
event	g-protein dissociation	1
event	g- twenty 	1
event	g- twenty  meeting 	1
gay club	g-a-y	1
monochrome image	g-band transmission image	1
multinational project	g- twenty-four 	1
original branded watch	g-shock	1
sexual technique	g-spot	1
county policy	g- fifteen 	1
efficiency feature	g-force of the spin cycle for better water removal	2
informal grouping	g- eight 	1
name brand jean	g-star	2
program	g- eight  global partnership against the spread of weapons 	1
ESR parameter	g-value	1
human cytokines	g-csf	1
Immunoregulatory cytokines	g-csf	1
kinesthetic sensation	g-loads for flight simulator	1
lineage-specific growth factor	g-csf	3
local high-tech company	g-tech	1
modern retail outlet	g-mart supermarket	1
program	g-mail	1
program	g-i's numerous award program	1
popstar princess guest artist	g-force	1
recommendation part	g-sensor	1
signaling enzyme	g-proteins	1
smart clothes	g-star t-shirts	1
white-knuckle ride	g-force	6
american streetwear brand	g-shock	1
army database	g- four 	2
army database	g- eight 	2
army database	g- one 	1
Ethiopians	g- seven 	1
free e-mail address	g-mail	1
high nickel alloy	g- thirty 	1
high-level forum	g- twenty 	1
horizontal network	g- seven 	1
pop culture star	g-man creator chris giarrusso	1
pure electric vehicle	g-wiz	1
radiation detection instrument	g-m detector	1
recognisable chain store name	g-star	1
seattle club	g-note	1
stationary iterative method	g-s	1
top urban name	g-unit	1
common cellular process	g-protein coupled receptor signaling	1
dnas	g-quadruplex-forming, biological dnas	1
free web-based account	g-mail	1
haemopoietic growth factor	g-csf	1
hemopoietin receptor	g-csf receptor	2
hemopoietinreceptors	g-csf receptor	2
intracellular binding protein	g-proteins	2
light-up accessory	g-strings	1
organophosphorus nerve agent	g-type agents sarin	1
popular acoustic artist	g-love & special sauce	1
popular drug target	g-protein coupled receptor	1
popular e-mail provider	g-mail	1
secondary DNA structure	g-quadruplex structure	1
organization	g- eight 	5
organization	g- seventy-seven 	2
stepper	g-line stepper	1
stocking aspirational brand	g-star	2
third-party e-mail client	g-mail	1
asian pb	g-dragon	1
banding pattern	g-banding	2
brand underpants	g-star	1
country grouping	g- twenty 	1
dirty-sounding special	g-spot	1
organization	g-coe of ncrs kyushu university co-organizing seminar	1
organization	g- seven 	1
exclusive name brand	g-unit	3
expensive sneaker	g-shock watches	1
global level	g- twenty  summit 	1
google mobile product	g-mail	1
great rod	g-loomis glx	1
haematopoietic growth factor	g-csf	3
hemopoietic growth factor	g-csf	7
hiphop clothes	g-unit	1
informal alliance	g- twenty-four 	1
informal alliance	g- seven 	1
informal alliance	g- twenty 	1
korean hip hop group	g-dragon	1
lineage-specific cytokines	g-csf	2
mens designer clothing brand	g-star	1
myeloid growth factor	g-csf	1
organization	g- fifteen 	1
organization	g- twenty 's financial stability board 	1
organization	g- twenty 	1
spectroscopic constant	g-factors	1
strong multilateral institution	g- eight 	1
successful domestic product	g- two 	1
successful domestic product	g- four 	1
throw-away email address	g-mail	1
trendy fashion brand	g-star	1
ultraviolet ray	g-line	7
underground network	g-cans flood defense system in the greater tokyo area	1
advanced receiver	g-rake receiver	1
amplifier adjustment	g-series	1
technique	g-randh-rthatgenerated small reduced suites with variable	1
bigbang member	g-dragon	1
blockbuster protein -therapeutic	g-csf	1
board service	g- two  furnishing meal 	1
constant mesh racing transmission	g-force	1
CSF	g-csf	1
CSFs	g-csf	1
designer jewelry	g-shock	1
domestic gene engineering drug	g-csf	1
dominant and powerful bloc	g- seventy-seven 	1
dynamic AGE model	g-cubed model	1
exposure wavelength technology	g-line	1
first team selection	g-mu guard gavin backus	1
First, information	g-code part program	1
force cueing device	g-suit	1
giant star	g-type giant star	1
hematopoietic agent	g-csf	1
hematopoietic cell growth factor	g-csf	1
hentai title	g-taste	1
hidden function	g-force	1
high profile associate training company	g-edge coaching	1
hip-hop ambassador	g- five 	1
independent and major clothing line	g-shock	1
large international gathering	g- eight 	1
leading anti-virus vendor	g-data	1
local shopping mall	g-market	1
performance compar-isonswithother well-known reliability model	g-o	1
popular e-mail service provider	g-mail	1
popular free e-mail client	g-mail	1
popular sportswear brand	g-star raw	1
settled R & D institution	g-spenor international consulting co.	1
small, secreted protein	g-csf	1
soil-applied formulation	g-max lite	2
space travel simulator	g-force accelerator simulator	1
specialist range	g-shock	1
spectral line	g-line	1
synthetic inorganic cation exchange material	g-zirconium phosphate	1
application	g-mail	1
Third, inflammatory cytokines	g-csf	1
top UK artist	g-force	1
top urban lifestyle brand	g-star	1
top-tier fashion designer	g-star	1
transmitter receptor	g-protein-coupled receptor	1
traqmate's unique mode	g-force	1
up-armoured production vehicle	g-wagen	1
valuable new product	g-csf	1
visible ray	g-line	1
welcomed significant new customer	g-iii apparel group	3
YG family artist	g-dragon	1
afh producer	g-p	1
britton wood institution	g- eight 	1
name	g-unit	7
name	g-shock	2
Casios	g-shock	1
cell-surface transmembrane protein	g-protein-coupled receptor	1
circuit construction	g- ten 	1
common circuit board laminate	g- ten 	1
company's various marketing activity	g-force	1
copy lens	g-clarons	1
CPU Nikkor lens	g-type nikkor	1
d-block's former arch rival	g-unit	1
DISCUSSION Hematopoietic cytokines	g-csf	1
Endogenous signal transduc-tionpathways	g-protein coupled receptor	1
essential omega-6 fatty acid	g-linolenic acid	1
name	g-spot	1
FREE unit	g-mail	1
fully electric car	g-whizz	1
fully electric plug-in car	g-wiz	1
G-8 subgroup	g- eight  anti-crime 	1
global art programme	g-clay	1
gps-enabled application	g-park	1
grain oriented specimen	g- eight 	1
grain oriented specimen	g- twelve 	1
gravel-based drainage system	g- two 	1
great cop movie	g-men with james cagney	1
guitar barre chord	g-major barre chord	1
hemapoietic growth factor	g-csf	1
high-level discussion	g- twenty  summits 	1
IFN-candhaematopoietic cytokines	g-csf	1
importing member	g- ten 	2
key political and economic union	g- twenty 	1
latest navigation feature	g-book information network service support	1
leica lens	g-rokkor  twenty-eight mm 	1
mammalian biological molecule	g-csf	3
manufacturers brand	g-star	1
missense mutation	g-to-a single-base substitution	1
Myelogenic cytokines	g-csf	1
nonbank-based service	g-cash in the philippines	1
offensive interest	g- twenty 	1
pegylating protein	g-csf	1
case	g- twenty-four 	1
case	g-n partners	1
ras superfamily guanine nucleotide-binding protein	g-proteins	1
recombinant colony-stimulating factor	g-csf	1
render preference	g-buffer	1
sev-erallight responsive element	g-box	1
sex associated condition	g- six -pd deficiency 	1
simple, non-invasive procedure	g-shot treatment	1
social medium layer	g-mail	1
south florida's top MMA organization	g-force	1
stimulatory growth factor	g-csf	3
stimulatory pharmaceutical	g-csf	1
street hop artist	g-unit	1
option	g-force meter	1
unstructured intergovernmental organization	g- eight 	1
up-and-coming pop singer	g-dragon from big bang	1
web-based mail program	g-mail	1
account noncanonical interaction	g-t base pairing	2
Administering cytokines	g-csf	1
aviation pulp	g- eight 	1
option	g-form xtreme sleeve	1
B2B firm	g-log	1
biosimilar product	g-csf	1
black sea fleet boat	g- five 	1
blood-cell growth stimulators	g-csf	1
branded jewelry	g-shock	1
casio solar watch	g-shock	1
classic cytogenetic technique	g-band karyotyping	1
classical karyotiping technique	g-banding	1
classical signaling component	g-proteins	1
Club IGOs	g- seven 	2
CNC scripting	g-code	1
collimated beam	g-line in the g one  hutch 	1
concomitant supportive treatment	g-csf	2
contrary, recombinant growth factor	g-csf	1
conventional cytogenetic method	g-banding	1
custom string	g-string from xxx archery	1
cytokine drug	g-csf	1
diminished 5th	g-flat	1
diplomatic grouping	g- seventy-seven 	1
directional guide sign	g- one 	1
disappointing dreck	g-force	1
DMRs	g- three  battle rifles used by the germans 	1
dynamic intertemporal general equilibrium model	g-cubed model	1
easily accessible service	g-line	1
group	g- twenty 	3
group	g- eight 	2
group	g- twenty-two 	2
group	g- eight  nuclear safety 	2
group	g- sixteen  group of donor 	1
economic summit	g- eight  summit 	1
EMIs	g-cash of ayala-controlled globe telecom	1
e-money product	g-cash in the philippines	1
enlarged group	g- twenty 	1
enlightening topic	g-d's creation of the world	1
expanded grouping	g- twenty 	1
famous ranch	g- four 	1
far-away wave	g-land	1
fast-acting synaptic transmitter	g-aminobutyric acid	1
fun vibe	g-spot vibrator	1
God weed	g- thirteen 	1
Goyas	g- fifteen 	1
guy carpenter's internally developed model	g-cat south africa earthquake	1
haematopoietic colony-stimulating factor	g-csf	1
hematopoietic stimulant	g-csf	1
HHV-8 gene	g-protein coupled receptor	1
high ticketed item	g-spot code	1
high-calibre shop	g-star	1
high-end weed	g- thirteen 	1
high-pressure laminate composite material	g- ten 	1
human colony-stimulating factor	g-csf	1
iconic jean first	g-star elwood	1
inclusive group	g- twenty 	1
group	g-force pakistan	1
group	g- seven 	1
informal dialogue	g- twenty 	1
informal international mechanism	g- eight 	1
Inhibitory neuro-transmitters	g-aminobutyric acid	1
Injection ofa cytokine	g-csf	1
integral and peripheral membrane protein	g-protein coupled receptor	1
international economic gathering	g- seven 	1
international leadership organization	g- eight 	1
kid-friendly movie	g-force	1
korean initiative	g- twenty  summit 	1
large gasoline engine	g- sixty-two  for power 	1
large grit	g- ten 	1
large ring laser	g- zero 	1
latest positional error model	g-band	1
letter-number response pair	g- five 	1
man flashy watch	g-shock	3
micro bikini	g-string	1
midi FX unit	g-major by tc electronics	1
mobilization agent	g-csf	1
monomeric protein	g-protein-coupled receptor	1
MRC membrane protein	g-protein-coupled receptor	1
MSRB rule	g- thirty-seven 	1
multi-lateral setting	g- eight 	1
multi-sectoral multi-country model	g-cubed model of mckibbin	2
myeloid stimulating factor	g-csf	1
nonbank-based implementation	g-cash in the philippines	1
method	g-csf elisa	1
normal g-technology hard drive	g-technology g-drive combo  one tb 	1
northern government-drive debt-related initiative	g- eight 's multilateral debt relief initiative 	1
OXDCs	g-oxdcs from collybia sp.	1
prefix designation General Staff	g- one 	1
premium streetwear brand	g-star	1
prokaryotic counterpart	g-proteins ffh	1
quirky electric runabout	g-wiz	1
rapper album	g-unit	1
rch phenomenon	g-forces on the human body	1
realiable engine	g- twenty-three 	1
recently-opened admiral's club	g-concourse at ord	1
Receptor inverse agonists	g-protein antagonist	1
regionwide effort	g- eight 's broader middle east 	1
second, extraregional forum	g- twenty 	2
method	g-banding	1
method	g-matrix method	1
sensory gene	g-coupled sensory receptor	2
shouldhemopoietic growth factor	g-csf	1
signature bluegrass lick	g-run on the guitar	1
significance index	g-index	1
standard structure validation parameter	g-factor obtained with the program procheck	2
successful Korean MCs	g-dragon	1
suitable protectant	g- fifteen 	1
Tapered Wrapped Graphite	g-force	1
thedirty.com celebs	g-girl	1
third-party tracking utility	g-lock analytics	1
today's production electric car	g-wiz	2
top -biological	g-csf	1
top-of-the-range powershot model	g-series	1
transparent annular plate	g- twelve  optical quality glass 	1
tool	g-mail	2
violent leftist	g- eight  protester 	1
welding galvanized steel	g- ninety 	1
world summit	g- eight 	1
Wrapped graphite	g-force	1
WTO group	g- twenty 	1
artist	g-unit	7
artist	g-stack	4
artist	g-dragon	4
artist	g-dep	1
material	g- ten 	4
place	g- seven  stream 	1
player	g- eight 	2
technology	g-con frames	2
term	g-power platinum	1
term	g-force	1
term	g-strings	1
parameter	g-value	1
measure	g-mean	1
condition	g- six -pd deficiency 	1
element	g-scale model train in the english garden enjoyed by visitors during the first weeks of december	1
element	g-forces	1
function	g-censor gravity detecting device	1
function	g-sensor	1
device	g-force	1
brand	g-star	20
brand	g-unit	7
brand	g-force	2
brand	g-star raw	1
brand	g-man	1
brand	g-plan	1
brand	g-star denim	1
brand	g-shock	1
concept	g-radical extension	1
component	g-strings	1
component	g-cadinene	1
site	g-spot near french cay	1
