property	gk energy conservation	4
client	gkn aerospace	2
business	gkn	1
firm	gkn	2
manufacturer	gkn	1
mean	gksu access under nautilus	1
Organisations	gkn aerospace	1
Organisations	gkn	1
standard	gks	1
store	gk vale	1
store	gkb	1
brand name	gk	1
corporation	gkn	1
package	gks	1
university	gkt	1
artifact	gkathead pentagram	1
supplier	gkn	1
top brand	gk bennett	1
large company	gkn	1
competition	gk test	1
competition	gk quiz	1
NGOs	gk	1
rival	gkn of the uk	1
industry leader	gkn	1
household name	gkn westland	1
developer	gk developers	3
participant	gkn aerospace	1
hospital	gk hospital	1
circuit	gkc	1
international company	gkn aerospace	1
international company	gkn	1
donation	gk tent rental of tecumseh	1
leading company	gkn aerospace	1
global company	gkn	1
abbreviation	gk.	1
industry player	gkn	1
best brand	gk	2
broker	gk goh	1
area	gk i	1
famous company	gkn	1
great company	gkn	1
string	gk-assigned terminal identity string	1
APIs	gks	1
industry partner	gkn	1
affiliate	gk films	2
affiliate	gki energy research ltd.	1
affiliate	gki health research ltd.	1
affiliate	gki-enet ltd.	1
affiliate	gki consulting ltd.	1
blue-chip company	gkn	1
world-class company	gkn	1
great show	gk's  eighty th birthday 	1
world class company	gkn westland aerospace	1
big employer	gkn aerospace	1
approval	gkrh	1
aerospace company	gkn aerospace	1
company	gkn	17
company	gkn westland aerospace	2
graphic package	gks	1
company	gkc theatres	1
company	gkn plc.	1
company	gkn sintered metals	1
company	gkr karate	1
popular school	gkd matriculation	1
leading supplier	gkn	1
best brand name	gk	1
registrar	gkg	1
automotive supplier	gkn	1
Large NGOs	gk	1
component maker	gkn	1
software standard	gks	2
graphic system	gks	2
large global player	gkn	1
hard-to-find ingredient	gkrachai in brine	1
standard company	gks infoysis	1
x-linked condition	gkd	1
private sector defense firm	gkn aerospace	2
household sewing machine	gk nine - two 	1
information sharing tool	gk-aims database	1
britain's biggest firm	gkn	1
organization	gkn	1
year's big event	gk seminar	1
boeing's supplier	gkn	2
company's independent distributorships	gkg	1
Hebraists	gkc	1
piedmont triad manufacturer	gkn	1
prize article	gk book	1
solid business	gkn	1
air knife unit	gk single knife de-stoner available from general kinematics ltd	1
counting mechanism	gk cac	1
countless community-based health organization	gk in bangladesh	1
dubious pyramid scheme	gko-ofz at the state	1
Engine overhaulers	gkn chem-tronics	1
graphical KB editor	gkb editor	1
household name manufacturer	gkn	1
Minimal invasive treatment	gks	1
case	gkr karate	1
additive aggregationmethod	gk method	1
cold and oligotrophic lake	gks	1
device-independent graphic package	gks	1
Ginkgolides	gka	1
GK area	gk esperanza in the province of sultan kudarat	1
hebrew grammar	gkc	1
group	gkn	1
innovative UK company	gkn	1
large graphic interface	gks	1
long-lived company	gkn	1
monitoring window	gkrellm	1
password protected item	gk phone list	1
standard graphic programming tool	gks	1
toe jack	gks	1
UK first tier international firm	gkn	1
place	gk-ii	1
player	gkn	1
site	gk mapayapa	1
site	gk cypress	1
