initiative	gvrd regional sustainability initiative	1
situation	gv	1
author	gv desani	1
alternative	gvsig	1
agent	gva	1
criterion	gvm	1
firm	gva grimley	1
indicator	gvw	1
feature	gv	1
complication	gvhd	4
instance	gvp's funeral	1
country	gvep facilitator workshop country	1
building	gvrd municipal building	1
format	gvf	1
risk factor	gvhd	2
stakeholder	gvrd	1
language	gvm for specific application	1
producer	gvk power	1
university	gvsu	1
platform	gvt's broadband network	1
molecule	gvb pair input forum molecule	1
apps	gvim	1
authority	gvrd	1
stock	gvk power & infrastructure	1
factor	gvhd	2
issue	gvhd prophylaxis	1
NGOs	gvt in india	2
NGOs	gvt	1
community event	gvc big show	1
index	gva per head	1
reaction	gvhd	2
community group	gvshp	1
big company	gvk power	1
local group	gvrd	1
airport	gva	1
pest	gvb	1
survey	gvu	1
survey	gvu web user survey	1
serious side effect	gvhd	1
educational institution	gvsu	1
private company	gvk power	1
microorganism	gv of the indian meal moth	2
microorganism	gv of the grapeleaf skeletonizer	2
pathological condition	gvhd	1
interesting place	gville zoo	1
economic indicator	gva per employee	1
clinical factor	gvhd	1
indian company	gvk	2
indian company	gvk power	1
area	gva	1
area	gvrd	1
business group	gvcc	1
app	gvmynumber	1
app	gvcallback	1
advanced capability	gvrp	1
trial	gvhd & copd	1
factor	gvf	1
factor	gvw	1
factor	gvwr limit	1
material parameter	gvd	1
service	gvsu	1
basic statistic	gvw	1
free alternative	gvsig	1
conventional measure	gva	1
third-party vendor	gv & associates	1
indian firm	gvk power & infrastructure	1
indian firm	gvk	1
private operator	gvk group	1
immune disorder	gvhd	1
infrastructure company	gvk	1
incidental fee	gvw	1
company	gvk	3
company	gvk infrastructure	2
company	gv meditech	1
equity	gva	1
equivalent	gvs	2
company	gvk power & infrastructure	1
municipal building	gvrd municipal building	1
parcel	gvc parcel	1
productivity measure	gva per worker	1
corporate house	gvk	1
company	gvk aviation pvt. ltd	1
company	gvk biosciences	1
external consultant	gva	1
leverage tool	gvo conference	1
factor	gvhd prophylaxis	1
digital interface	gvif	1
conventional indicator	gva growth	1
information	gvwr	1
Indian corporates	gvk group	1
monitoring agency	gvrd	2
vehicle attribute	gvw	1
perennial advertiser	gv	1
perennial advertiser	gv snowshoes	1
time-dependent factor	gvhd	2
linear effect	gvd	1
pathophysiological event	gvhd	1
fibrotic disorder	gvhd	1
infrastructure firm	gvk	1
survey organization	gvu	1
wad	gvh	1
mpanies	gvk b	1
ptcs	gvt	1
free editor	gvim	1
indian power generation company	gvk power	1
program	gvp	1
program	gvsig	1
political association	gv joshi	1
comprehensive network management function	gvrp for vlan configuration	1
GV series card	gv video capture card	1
GV series card	gv-hybrid dvr card	1
GV series card	gv-dsp card	1
short-range event	gvhd	1
transplant-related complication	gvhd	1
transportation interest group	gvta	1
factor	gvhd prophylaxis protocol	1
power generation company	gvk power & infrastructure	1
airport indian company	gvk	1
arcane measure	gvt debt	1
commercially available mobile platform	gvm	1
consequently company	gvk	1
effector cell-mediated disease	gvh disease	1
IEEE protocol	gvrp	1
land acquisition program	gvrd regional parks system	1
lifting program	gvt	1
wireless internet platform	gvm	1
desktop GIS package	gvsig	1
dicators	gva	1
dynamic VLAN trunking protocol	gvrp	2
forum molecule	gvb pair input forum molecule	1
free desktop GIS software project	gvsig	2
genogroups	gv	1
large snowshoe	gv mountain trail	1
pampanga-based FM radio station	gvfm  ninety-nine . one 	1
post-transplant variable	gvhd	1
speciality staff	gv instructor	1
sterile suburban area	gv	1
transplantation-related adverse effect	gvhd	2
village level organization	gvm	1
VLAN management protocol	gvrp	1
abroad class ofmultiagent optimization task	gv scheduling	1
active contour force model	gvf	1
asset development company	gvk	1
equivalent algorithm	gvs	1
exotic anticancer vaccine	gv one thousand and one  antitelomerase vaccine 	1
Google Voice apps	gv mobile	1
group	gvrd	1
method	gvb	2
oral carbapenem derivative	gv  one hundred and eighteen thousand eight hundred and nineteen x 	1
pet weight loss program	gvh fit pet program	1
posttransplantation factor	gvhd	1
regional outcomes-economic indicator	gva	1
senior government	gvrd	1
simulator facility	gvt	1
single-shot mechanism	gva	1
urban government	gvrd	1
x-windows	gvim	1
player	gvta	1
player	gvk power	1
parameter	gv	1
measure	gva	1
measure	gva per head	1
variable	gvwr class	2
variable	gva	2
variable	gvhd	1
concept	gvt	1
