resource	hkkh decision support toolbox software	1
product	hks	1
product	hk's optimum overalls	1
exception	hku	1
model	hk  six thousand two hundred 	1
model	hk  three thousand four hundred and eighty 	1
institution	hkiac	1
client	hkust	1
matter	hkid card number	1
alternative	hk p thirty 	1
course	hkin  one thousand one hundred and fifty-one 	1
star	hk actress anita yuen	1
school	hku space	1
school	hkust	1
type	hks	1
city	hk	2
firm	hks of dallas	1
firm	hkr international	1
manufacturer	hks	2
country	hk	1
Organisations	hk philharmonic orchestra	1
show	hk tvb drama	1
design	hk  four hundred and sixteen 	1
sector	hk telecom	1
sector	hk utility	1
award	hk firodia memorial award	1
speaker	hkstp	1
trend	hk having handshake problem	1
brand name	hks	1
weapon	hk twenty-one 	1
weapon	hk usp compact	1
luminary	hk film luminary	1
university	hkust	3
university	hku	1
platform	hk usp	1
composer	hk gruber	1
symbol	hk one 	1
symbol	hk two 	1
top brand	hks	4
top brand	hk top brand	1
user	hku space student	1
upgrade	hks bov	1
authority	hkma	2
issue	hklm access in the registry	1
society	hkl support group	1
carrier	hkbn	1
popular brand	hks	1
maker	hks	1
personal information	hkid card number	2
name brand	hks	1
notable exception	hk- fourty-seven 	1
reference	hklm window nt winlogon reference	1
engine	hks	1
link	hk government home page	1
art	hkd	1
route	hkg-lhr	1
airport	hkg	6
airport	hkia	1
delicacy	hk famous little delicacy	1
item	hk	1
set	hk tv set	1
big brand	hks	1
outfit	hks	1
mod	hks hi power	1
mod	hks ssqv	1
item	hks racing suction reloaded kit	1
gun	hk usp	1
gun	hk four hundred and seventeen 	1
tourist spot	hk space museums	1
exhibition	hk fair	1
key	hklm	1
battery	hk  one hundred and thirty-eight  mah 	1
top name brand	hks	1
prestigious award	hku outstanding young researcher award	1
prestigious award	hku outstanding research student supervisor award	1
trade association	hkta	1
currency	hkd	2
coin	hkd	1
treaty	hk-china tax treaty	1
local delicacy	hk style milk tea	1
scholarship	hktiit scholarship	1
acronym	hkcee	1
rifle	hk- ninety-one 	3
rifle	hk g three 	3
rifle	hk  four hundred and sixteen 	2
rifle	hk  four hundred and seventeen 	1
logo	hks	1
japanese company	hks	1
radio	hknn four thousand and two 	1
manufacture	hks	1
firearm	hk- ninety-three 	1
firearm	hk-type	1
disc	hkl pal disc	1
great character	hk- fourty-seven 	1
amp	hk with neutral	1
large scale event	hkpc's annual dinner	1
blue chip	hk bank	2
theoretical model	hkf equation of state	1
gateway	hkg	1
professional qualification	hkis	1
professional qualification	hkicpa	1
television channel	hktb	2
complex trait	hkw	2
shipping option	hk post	1
conversion	hks vpc	1
secondary school	hk island school	1
secondary school	hk west island school	1
small venue	hksar	1
hunter	hk- fourty-seven 	1
gig	hk live	1
mega-projects	hk's union square	1
student leader	hkfs ex-chairman cheung yin tung	1
tuner	hks	1
european manufacturer	hk audio	1
famous restaurant	hk diner	1
aftermarket product	hks	1
alarm system	hkc	1
japanese manufacturer	hks	1
photo identification	hkid card	1
company	hks	12
company	hkpb offer nenagh sustainable growth into the future	2
company	hks & greddy from japan	1
company	hkb	1
company	hkd	1
company	hk systems	1
performance venue	hkcc concert hall	1
top official	hkma chief norman chan tak-lam	1
departmental store	hkb	1
award program	hkcss-citi continuous learning recognition scheme	1
contemporary piece	hk gruber's exposed throat	1
vender	hks	1
china tv channel	hkatv	1
initial	hk for hilda koronel	1
shotgun	hk five hundred and twelve  from germany 	1
assault rifle	hk g three 	2
assault rifle	hk g thirty-six 	1
assault rifle	hk four hundred and sixteen 	1
assault rifle	hk- ninety-one 	1
animal shelter	hk cats	1
animal shelter	hk alley cats	1
camera system	hkme alarm systems	1
aftermarket company	hks	1
wildlife park	hkabo razi	1
international art fair	hk art fair	1
quasi-governmental organization	hktdc	1
bounty hunter	hk- fourty-seven 	1
military rifle	hk ninety-one   ninety-three   fifty-one   fifty-three   ninety-four 	1
droids	hk- fourty-seven 	1
droids	hk-series assassin droids	1
regional exchange	hkex	1
arbitration institution	hkiac	1
knowledge institution	hku	1
local hotspot	hkan hookah bar	1
power utility	hk electric	1
tuning company	hks	1
defensive play	hk utility	1
fast-growing company	hkbn	1
ignition system	hks dli	1
forum site	hk forum site	1
outstanding city	hk	1
statutory regulation	hkma regulation	1
acclaimed tourist attraction	hk museum of art	1
acclaimed tourist attraction	hk cultural centre	1
acclaimed tourist attraction	hk space museum	1
submachine gun	hk mp five 	2
battle rifle	hk ninety-one 	2
offer brand	hks	1
national and international firm	hks	2
PDWs	hk mp seven 	1
distinguished global business school	hkust	1
film luminary	hk film luminary	1
high-end supermarket	hk citysuper	1
large frame pistol	hk	1
mm rifle	hk four hundred and sixteen 	1
program	hkl suite	1
popular aftermarket brand	hks	1
subguns	hk mp- five 	1
competitive society	hksar	1
internet exchange	hkix	1
piggyback	hks is	1
semi-auto rifle	hk four hundred and seventeen 	1
sporting brand	hks	1
top JDM brand	hks kansai	1
unregistered group	hkfyg hong kong melody makers	1
writers group	hk writer's circle hosts writing crits	1
electronic boost controller	hks evc iv	1
highest quality name brand	hks	1
international arena	hkust	1
lattice reduction algorithm	hkz reduction	1
trustworthy shipping service	hk post	1
tv set	hk tv set	1
computer center	hk golden	1
organization	hk community fund	1
famous exhibition	hktdc housewear fair	2
fully interactive weapon	hk usp pistol	1
local major medium channel	hk economic times	1
organization	hketo	1
organization	hki in partnership with usaid	1
respected japanese brand	hks	1
technology superstar	hk systems	1
universal brand	hks	1
well-known import name	hks	1
X2.2 material	hk	1
9mm carbine	hk mp- five 	1
academic advisory board	hku space business studies faculty	1
asian hub	hkg	1
biggest international airport	hkia	1
ember	hkva m ember	1
Experiencing coilovers	hks hipermaxii's	1
famous tuning shop	hks kansia	1
GT-R tuner	hks	1
internationally prominent ADR institution	hkiac in hong kong	1
local fire safety authority	hk fire services department	1
MHA vendor	hk systems	2
mimicking gun	hk mp five 	1
named brand	hks	1
national protected area	hkakaborazi national park	1
application	hks blow	1
plethora highly wealthy socialist nation	hk	1
regional executive	hk-based adam chang	1
application	hks intercooler	1
well-established activity	hkie school ambassadors programme	1
wine promotion	hktdc hong kong international wine & spirits fair	3
air pistol	hk p thirty 	1
asian-pacific currency	hkd	1
automobile part manufacturer	hks	1
name	hks	2
country-specific domain name	hk	1
full size gas piston type	hks	1
hi-end respectable company	hks	1
HK newspaper	hk standard	1
IRDIs	hkpc in hong kong	1
japanese fuel management system	hks	1
large japanese manufacturer	hks	1
neutrality test	hka test	1
Non-conserved yeast PTS1s	hkl	2
patient identification number	hk id	1
piston platform	hk	1
popular hong kong tourist attraction	hk disneyland	1
case	hks gt three thousand and fourty 	1
real time engine monitoring device	hks camp two 	1
registry sub-keys	hklm	1
registry sub-keys	hkcr	1
segment status code	hk	1
semiautomatic assault weapon	hk ninety-four  with a telescoping stock 	1
series rifle	hk ninety-one 	1
showcase structure	hkchina bank	1
sigma expert	hkpc for implementation	1
case	hkruk ii	1
case	hksar v. ma wai-wide case	1
option	hks rear rear housing	1
option	hk sight	1
unattended station	hkl	1
40A esc	hk blue selease	1
9mm rifle	hk umc with an ump conversion kit	1
aftermarket japanese exhaust system	hks	1
Application identifiers	hk id number	1
assassin droids	hk- fourty-seven 	2
automatic pistol model	hk usp universal self-loading pistol come in a variety of mechanism type	2
bulky gun	hk usp fourty-five 	1
cite country	hk	1
combat pistol	hk fourty-five 	1
cost-effective shipping method	hk post	1
currently available concept	hkf model for standard state property	1
dark side-oriented character	hk- fourty-seven 	1
dietary survey tool	hki food frequency questionnaire	1
HK university	hkust	1
HK's	hk fourty-five 	1
hour real-time datum	hk stock	2
human renal proximal tub-ularcellline	hk- two  cell line 	1
interesting new putative TSGs	hk one 	2
judgment enforcement agency	hk recovery group	1
large brand agency	hklm	1
large local and international conglomerate	hk bank	1
list gun	hk fourty-five 	1
lockhart road shop	hk hardware	1
long-lived keratinocyte line	hkc-n two  cell line 	1
modern high-pressure blowback system	hk g three 	2
non-cdi ignition system	hks dli	1
non-governmental development organization	hki	1
non-licence holder	hkbn	1
Outstanding staff	hkbn service technician winfield wong	1
OW hub	hkg	1
poor-scoring target	hk two 	1
pull type	hks	1
quality client	hksar department	1
racing jurisdiction	hkjc	1
rail upper receiver	hk four hundred and sixteen 	1
speedloaders	hks shown	1
stupid thought	hks t fifty-one -r 	1
Submachine gun s	hk mp five 	1
transactional entity	hkic movement	1
transition matrix	hky	1
true military weapon	hk four hundred and sixteen  assault rifle 	1
USNGOs	hki	1
weapon top	hk grenade pistol	1
web driven project	hkda system	1
well-liked asian airport	hkg	1
place	hkg	1
system	hks hi-power	1
system	hks camp two 	1
device	hks vein pressure converter work along the same line	1
brand	hks	7
brand	hk audio	1
brand	hk top brand	1
component	hkcg's other smaller component	1
component	hks head gasket	1
site	hk forum site	1
