model	hx	1
business	hxnw auto service ltd.	1
association	hxc	1
specific	hx pro	1
reagent	hx	1
extension	hxx	1
abbreviation	hx for history	2
visual element	hx break	1
explosive	hx two  antipersonnel mine 	2
monitoring technique	hx monitoring technique	1
molecular compound	hx acid	1
hex editor	hxd	7
hex editor	hxd hex editor	1
disk editor	hxd	2
australia line	hx airline	1
base analog	hx	1
video gaming device	hxt helmet	1
technique	hx monitoring technique	1
HOLDENS	hx	1
modular power supply	hx  six hundred and twenty 	1
civics	hx	1
case	hx twenty thousand  -hx thirty thousand   film application on train 	1
segment status code	hx	1
case	hx twenty thousand   film application on train 	1
ultra-efficient car	hx	1
disc editor	hxd	1
separate air-to-air heat exchanger	hxi series air-to-air heat exchanger from thermacore	2
project	hxc standalone	1
product	hxm available for evaluation	1
