product	jfs litigator's notebook	1
subject	jfk assassination	1
exception	jfk	1
attraction	jfk museum & library	1
person	jfk	1
approach	jff	1
agency	jfcom	1
course	jfk assassination	1
solution	jfreechart	1
feature	jfet circuitry	2
film	jfk	18
band	jfa	1
band	jfac	1
school	jfs	1
development	jfk district	1
city	jfk	4
drug	jfk abuse drug	1
man	jfk	2
compound	jfahanasoodry near eallylanders in limerick	1
class	jf	1
leader	jfk	3
movie	jfk	12
policy	jfm	1
country	jfk commitment speech other country	1
piece	jfk jr. s sail boat	1
effort	jfcom's standing joint forces headquarters concept	2
designer	jf rey	1
destination	jfk	2
machine	jf cards	1
issue	jfk assassination	1
corporation	jfc international	1
journal	jfr	1
university	jfk university in san francisco	1
domain	jfacc	1
restriction	jfk airport runway extension	1
station	jfk	2
station	jfm	1
athlete	jf houle	2
park	jfk plaza	1
evidence	jfk's brain	1
collection	jf rey	1
crime	jfk theft	1
programme	jfn	1
investor	jf asset's tam	1
fighter	jf- seventeen 	1
hospital	jfk medical center in palm beach county	1
advance	jfe engineering corporation's super fast charger	1
route	jfk-gnd	1
route	jfk-nrt	1
route	jfk-lhr	1
library	jfreechart	1
airport	jfk	26
airport	jfk in new york	3
airport	jfk international in new york	3
airport	jfk airport	2
airport	jfk international airport	2
airport	jfkennedy in new york	1
international company	jfe steel	1
item	jfcs helping hands	1
historical figure	jfk	2
serious issue	jfk assassination	1
heading	jf	1
extension	jfinalizer	1
officer	jfacc for operation allied force	1
place name	jfk federal building	1
popular destination	jfk international airport ny	1
democrat	jfk	5
government program	jfm	1
historical event	jfk assassination	1
interesting place	jfk port authority police	1
semiconductor device	jfet	2
public figure	jfk	1
liberal	jfk	2
controversial topic	jfk assassination	1
political leader	jfk	1
political figure	jfk	1
president	jfk	10
city's attraction	jfk memorial	1
local activity	jfk pool	1
famous site	jfk memorial	1
famous celebrity	jfk	3
hub	jfk in new york city	1
great leader	jfk	1
great man	jfk	2
area	jfk ramp	1
famous figure	jfk	1
semiconductor	jfet transistor	1
famous person	jfk	1
file system	jfs	4
active device	jfet	1
missionary	jfj	2
pundit	jf beck	1
commander	jfacc	1
motion picture	jfk	1
high profile project	jfk federal building in boston	1
style icon	jfk	1
functional component	jfacc	1
open source tool	jffnms	1
campus resource	jfk library	1
international airport	jfk	5
international airport	jfk airport in new york	1
crowded area	jfk	1
correspondent	jf warren	1
job site	jfk airport	1
exciting attraction	jfk memorial museum	1
topic	jfk assassination	1
prominent person	jfk	1
popular subject	jfk assassination	1
standard technology	jfc	1
heros	jfk	1
american icon	jfk	1
famous leader	jfk	2
other country	jfk commitment speech other country	1
traffic generator	jfk airport	1
fabric company	jf fabrics	3
large-scale system	jfacc after ne xt	1
great figure	jfk	1
busy airport	jfk	2
java technology	jfc	1
filesystems	jfs	4
filesystems	jffs two 	1
large airport	jfk	3
company	jfe steel	1
company	jf schreiber	1
shipbuilder	jfe holdings	1
steelmakers	jfe steel corp.	1
award-winning film	jfk	1
hub airport	jfk	1
open source component	jfreechart	1
international gateway	jfk	1
component type	jfet transistor	1
application programming interface	jfc	1
democratic president	jfk	3
notable politician	jfk	2
activity	jfc innovation awards for rural business	1
activity	jfss information evening	1
white man	jfk	1
hybrid product	jfs litigator's notebook	1
york landmark	jfk airport	1
big airport	jfk	1
high-profile film	jfk	1
great president	jfk	1
liberal icon	jfk	1
great world leader	jfk	1
air platform	jf- seventeen 's 	1
domestic airport	jfk	1
letter acronym	jfk	1
event	jfk assassination	2
progressive democrat	jfk	1
world-changing event	jfk's assassination	1
boston attraction	jfk presidential library & museum	1
hollywood hit	jfk	1
popular president	jfk	1
greatest president	jfk	1
transistor technology	jfet	1
ski star	jf houle	1
ski star	jf cusson	1
touch topic	jfk connection	1
area airport	jfk	1
event	jfk's assassination	1
event	jfk's inauguration	1
DARPA program	jfacc after next	2
difficult subject matter	jfk assassination	1
heavily discounted brand	jf rey	1
java object	jfreechart chart setting	1
typical linux file system	jfs	1
washington attraction	jfk center for performing arts	1
york airport	jfk	1
advanced management technique	jfc	1
classic liberal	jfk	1
information campaign	jfy's poster campaign	1
local file system	jfs	2
program	jfs's care at a norc	1
pirate station	jfm	1
world-renowned personality	jf kennedy	1
advanced file system	jfs	1
palm's database	jfile	1
u-boot supported file system	jffs two 	1
indian outfit	jfk international	1
Japanese steelmakers	jfe holdings inc	1
jewish school	jfs	1
popular filesystems	jfs	1
real-life heroes	jfk	1
transistor related technology	jfet	1
air carrier airport	jfk	1
dense, high traffic route	jfk - sdq	1
flash file system	jffs two 	2
good, open-source finite automaton package	jflap	1
legislative function	jfac hearing	1
native file system	jfs	1
organization	jfc's operational liaison	1
organization	jfe corporation	1
UNIX file system	jfs	1
animal painter	jf herring	1
best-managed airport	jfk	2
busiest airport	jfk	1
cheating politician	jfk	1
destination airport	jfk	1
epoxy resin product	jf	1
extremely entertaining historical film	jfk	1
famous GA fatality	jfk jr	1
good historical film	jfk	1
graph library	jfreechart	1
great pirate soul station	jfm	1
Hans Sachs's Fastnachtsspiele	jfraw warkeit wil nicmand herbergen	1
japanese steel mill	jfe	3
japan's mill	jfe kashima	1
joint production project	jf- seventeen  fighter aircraft 	2
Journaling filesystems	jfs	1
large airline hub	jfk in new york	1
popular american leader	jfk	1
proven and unproven conspiracy	jfk assignation	1
silicon carbide semiconductor device	jfet	2
superyacht exhibitor	jfa	1
unified command	jfcom	1
worthy president	jfk	1
abuse drug	jfk abuse drug	1
AF first class lounge	jfk	1
biographic al film	jfk	1
name	jfk	2
common conspiracy theory	jfk	1
conditional instruction	jf	2
cornerstone investor	jf asset management	1
crucial positive figure	jfk	1
DL hub	jfk	1
Ethnic distributors	jfc	1
famous TV event	jfk assassination	1
fifth-year veteran	jf renaud	1
first-year fiascos	jfk's bay of pigs	1
flash-based file system	jffs two 	1
high quality home team	jf	1
ice skating rink	jfk coliseum in manchester	1
importing state trader	jfa	1
japan's major steel producer	jfe steel	1
jewish secondary school	jfs	1
jugular foramen tumor	jf schwannoma	1
letter aiport code	jfk	1
factor	jfc's objective	1
long haul	jfk-nrt in coach	1
mature filesystem	jfs	1
mid 20th century icon	jfk	1
Potential Filesystems	jfs	1
profitable route	jfk	1
renown frame designer	jf rey	1
special-purpose file system	jffs two 	1
superior oliver stone movie	jfk	1
option	jfk airport transportation	4
option	jfk limousine service	3
option	jfk car service	3
three-letter airport code	jfk	1
tri-state airport destination	jfk	1
BA lounge	jfk	1
big conspiracies	jfk assassination	1
binary image file	jfif formatted image	1
bloated command	jfcom	1
co-management strategy	jfm	1
community forest management program	jfm	1
community forestry program	jfm in india	1
complete, dedicated system	jfi kit	1
cultural and social acronym	jfk	1
dead public figure	jfk	1
dedicated flash file system	jffs two 	1
option	jf- seventeen 	1
option	jfk limousine assistance	1
engineered wood flooring specialist	jfj flooring	1
era film	jfk	1
Flash-based fi lesystems	jffs two 	1
Flash-based filesystems	jffs two 	1
functional component commander	jfacc	4
high-profile centre	jfk arboretum in co wexford	1
high-quality and popular component	jfreechart	1
historical blockbuster movie	jfk	1
group	jfj	1
international gateway airport	jfk	1
jnlp file	jfdraw.jnlp at jfimagine.com website	1
legacy flash file system	jffs two 	1
limited financial and material resource	jf equipment's	1
Linux log-structured flash filesystems	jffs two 	1
Linuxlog-structured flash filesystems	jffs two 	1
Linuxlog-structured flashfilesystems	jffs two 	1
manual-entry datum software	jfg harness handicapping software	1
modern day conspiracy theory	jfk	1
NAND flash file system	jffs two 	1
newsletter subscription	jfox news	1
over-consumed airport	jfk	1
pakistan air force initiative	jf- seventeen  program 	1
physician-developed line	jf aesthetic	1
popular airport	jfk	1
pseudo warrior	jf kerry	1
quincy attraction	jfk presidential library & museum	1
random CT	jfk assassination	1
reinacting famous assassination	jfk	1
single air officer	jfacc command airpower	1
single engine	jft	1
standalone non-ib broker	jf apex	1
submenu option	jfw help topics	1
surely airport	jfk	1
syle icon	jfk	1
totally local file system	jfs	1
trading participant	jf apex securities bhd	1
trans-atlantic route	jfk	1
well-known java library	jfreechart	1
york's major transportation hub	jfk	1
young president	jfk	1
project	jfk library in boston	5
project	jfk museum	1
artist	jfk from mstrkrft	1
term	jfa	1
system	jfs	2
system	jfm	1
system	jfk airtrain in new york city	1
device	jfet without gate	1
brand	jf manufacturing	1
site	jfk homestead	1
site	jfk's grave	1
