product	jgtc front bumper	1
product	jgtc gt five hundred  style rear spoiler 	1
game	jgr	1
exception	jg thunder maul	1
institution	jgh	1
author	jg ballard	1
author	jg faherty	1
writer	jg ballard	4
book	jg ballard's the drowned world	1
business	jg king homes	1
scholar	jga pocock	1
requirement	jgmp	1
manufacturer	jgb enterprises	1
manufacturer	jg	1
unit	jgs  fifty-one 	1
market	jgb market	1
scheme	jgsy	1
algorithm	jg-tree	1
car	jgtc car	1
driver	jg parry thomas	1
large company	jg entertainment	1
novel	jg ballard's semi-autobiographical novel	1
novel	jg ballard's the drowned world	1
industry leader	jgc	1
church	jgc	1
interest group	jga	1
library	jgl library from objectspace	1
library	jgl library from objectspace objectpspace.com	1
heavyweight	jgc corporation	1
contractor	jgc	1
contract	jgb	1
comment	jgeadm watch movies online wfbrsgp every day	1
gun	jg g thirty-six c for a rental gun 	2
file type	jgep	1
conglomerate	jg summit holdings	1
chinese company	jg	1
japanese company	jgc	2
japanese company	jgc corp	1
gym	jg mma academy in west chester twp	1
investment company	jg wentworth	1
clone	jg bar- ten 	1
store brand	jg higgens for sporting good	1
property developer	jg summit	1
faves	jgl	1
company	jg	2
national heroes	jg zuma	1
infrastructure program	jgsy	1
company	jg summit holdings inc.	1
big program	jgofs	1
external library	jgl	1
tax policy	jgtrra	1
japanese corporation	jgc corp	3
private partner	jg summit holdings	1
great website	jg	1
third party library	jgraph	1
contracting company	jgc	1
renal lesion	jga	1
EPC contractor	jgc	1
Fiction-writers	jg ballard	1
java IDE	jgrasp	1
clone manufacturer	jg	2
country's industrial giant	jg summit petrochemical corporation	1
great seller	jg	1
non-operating company level	jg wentworth incorporation	1
non-operating company level	jg wentworth llc	1
non-operating company level	jgw holdco	1
name	jg wentworth	1
name	jg strijdom drives in randburg	1
free integrated development environment	jgrasp	1
Japanese EPC	jgc	1
publishing author	jg ballard	1
TM Clones	jg	1
ada product	jgnat	1
FW190 fighter group	jg fifty-one  in  one thousand nine hundred and fourty-three 	1
high end airsoft gun	jg gun	1
java alternative	jgoodies binding	1
notable insitutions	jgsom of ateneo	1
NSX model	jgtc raybrig nsx	1
OTU	jgr sued	1
philippine conglomerate	jg summit	1
skilled joinery service	jg joinery	1
standard UI Binding package	jgoodies binding	1
tool	jgr	1
player	jgr	1
product	jgtc front canards	1
product	jgtc front underbody diffuser	1
system	jgrasp	1
brand	jg	4
brand	jg airsoft	1
