product	jhonsons holiday skin	1
ophthalmologist	jhansi raju	1
character	jhong hilario	1
work	jha et al	1
client	jhr	1
author	jhumpa lahiri	8
location	jharsuguda	1
writer	jhumpa lahiri	8
writer	jhh de waal	1
book	jharkhand paridrishya by sunil kumar singh	1
film	jhankaar beats	3
film	jhansi ki rani	1
school	jhu	6
practice	jhatka	1
city	jhang	1
city	jhelum	1
celebrity	jh hofmeyr	1
town	jhunjhunu	1
individual	jhumpa lahiri	1
unit	jhi	1
musician	jherek bischoff	1
song	jhuto satya	1
song	jhoot bole kauwa kaate	1
team	jhu	1
variety	jhona  three hundred and fourty-nine 	1
Organisations	jharkhand vikas morcha	1
big name	jhonattan vegas	1
effort	jhove	1
restaurant	jharokha	1
student	jhamar johnson	1
provider	jhp	1
top quality inn	jh adams inn	1
party	jhu	1
district	jhapa	4
district	jhang	2
district	jhalawar	1
district	jhajjar	1
district	jhabua	1
state	jharkhand	107
state	jharkand	5
state	jhala princely state	1
journal	jhet	1
festival	jhoolan	1
landmark	jhs bowl	1
university	jhu	1
university	jhb	1
file	jheadstart-specific file	1
platform	jhoomla	1
service provider	jh piego health organisation	1
supplier	jhs	1
card	jhudora's wand	1
vegetable	jhinga	1
college	jhu	1
veteran	jhonny peralta	1
centre	jhansi	1
river	jhelum	4
river	jhakan rao	1
spot	jhong - lu keng wetland	1
programme	jhalak dikhla jaa	1
command	jhotdrawoffers various command	1
investor	jh partners	1
level	jh	1
heroes	jhansi ki rani	1
production	jhankar	1
route	jhb	1
exhibit	jh- seven 	1
waste	jhama coal in iron	1
item	jh weight	1
blogs	jh underground	1
ship	jhelum	1
visitor	jhinda ram	1
patient	jh	1
government	jharkhand	1
prospect	jhoulys chacin	1
clothes	jhane barnes	1
temple	jhulelal mandir	1
instructor	jhoon rhee	1
reputable company	jht pest pros in silicon valley	1
historic building	jhongyang road	1
political party	jhu	1
area	jharkhand	3
area	jhal magsi	2
area	jhaveri bazar	2
area	jhansi	2
connector	jh	1
Americans	jh	1
novelist	jhumpa lahiri	1
marking	jhp	1
great band	jhonnyboy & the ice cream	1
intrinsic factor	jh-modulating allatostatin peptides	1
famous personality	jhonty rhodes	1
area	jhabua	1
area	jhal magsi district in balochistan	1
small city	jhelum	1
elective course	jh computer	1
hand	jh js  nine s  eight s  seven s 	1
contemporary writer	jhumpa lahiri	1
golfer	jhonattan vegas	1
area	jhotwara	1
local name	jhajra	1
great master	jhoon rhee	1
robot	jhu steady hand robot	1
house specialty	jheena mirch marsala	1
film director	jhon woo	1
small state	jhk	1
land use practice	jhum	1
working condition	jhds' working condition	1
sort	jhp	1
investment company	jh whitney advisors	1
international designer	jhanes barnes	1
young gun	jharal yow yeh	1
state government	jharkhand	2
renowned author	jhumpa lahiri	1
pocket	jhabua	1
folk dance	jhoomer	1
famous case	jhessye shockley	1
service department	jhu tax office	1
industrial town	jharsuguda	1
social network site	jhoos	1
transformer	jhiaxus	1
popular form	jhakdi	1
small-scale project	jhai fair-trade coffee cooperative on the bolaven plateau	2
minor exception	jhereg organization	1
design firm	jhp	1
malpractice	jhuma	1
dominant species	jhingan	2
young pitcher	jhoulys chacin	1
developed state	jharkhand	1
big school	jhu	1
indian state	jharkhand	1
large provider	jhp	1
eastern state	jharkhand	1
acclaimed author	jhumpa lahiri	1
comic artist	jhonen vasquez	1
contract manufacturer	jhs svendgaard labs	1
regional party	jharkhand vikas morcha	1
online journal	jhep	1
company	jhc securities	1
company	jh snyder co.	1
company	jh professional plastering	1
poor state	jharkhand	4
training company	jhl inc.	1
city name	jhb	1
ecological change	jhum cultivation in upper catchments of the river	1
non-traditional area	jharkhand	1
rebel leader	jhansi rani lakshmi bai	1
indian writer	jhumpa lahiri	1
south african artist	jh pierneef	2
personal gift item	jhola bags	1
activity	jha development	1
activity	jhankis	1
trunk road	jhongshan rd.	1
CAs	jhpi ego	1
folk song	jhumar	1
software environment	jhdl	1
big shot	jhon viafara	1
princely state	jhala princely state	1
tribal area	jharkhand	1
tribal area	jhabua	1
ammunition	jhp	1
landlocked state	jharkand	1
local cultural activity	jhanda diwas	1
short story collection	jhumpa lahiri's unaccustomed earth	1
proven player	jhonny peralta	1
low-cost device	jhai pc	1
eastern UP district	jhansi	1
poorest state	jharkhand	2
well-known tourist destination	jhunjhunu	1
backward state	jharkhand	1
elected leader	jhakku prasad subedi	1
small budget film	jhankaar beats	1
legendary golfer	jh taylor	1
under-banked state	jharkhand	4
mineral-rich state	jharkhand	2
polearms	jhi	1
accommodation establishment	jhelum boys hostel	1
Agroecosystems	jhum	1
granite kitchen tile	jhansi red granite kitchen tile	1
underbanked state	jharkhand	1
AKC title	jh	1
contemporary state	jharkhand	1
history department	jhu	1
moo	jhm	1
program	jhsv program	1
program	jhu	1
sub-castes	jhalli gill	1
beautiful pass	jhari la	2
contemporary book	jhumpa lahiri's interpreter of maladies	2
large indian state	jharkhand	1
low-prevalence state	jharkhand	1
political outfit	jharkhand mukthi morcha	1
asian-american writer author	jhumpa lahiri	1
athletic man	jhonattan vegas	1
factor	jhum cultivation	1
european clothing line	jhane barnes	1
jhala princely state	jhalawar	3
karate title	jhoon rhee nationals	2
low income state	jharkhand	1
maoist-affected state	jharkhand	1
rivulet	jhoda	1
social or community dance	jhumaila	1
social or community dance	jhora	1
state journal	jharkhand high court reports	1
uttar pradesh district	jhansi	1
bakery shop	jharkhand bakery	1
darkly humorous, offbeat comic	jhonen vasquez s johnny the homicidal maniac	3
darkly humorous, offbeat comic	jhonen vasquez's johnny the homicidal maniac	1
high end tool	jh williams	1
mind here particularly contemporary text	jhumpa lahiri's the interpreter of maladies	1
organization	jhs work	1
second-generation choreographer	jhelum paranjape	1
Shabeehs	jhoola	1
athletic guy	jhonattan vegas	1
attainment	jhana	1
community practice	jhum	1
Dalits	jhalkari bai	1
developmental hormone	jh	1
differend bullet type	jhp	1
FONKAR leader	jh owusu acheampong	2
international salsa performer	jhesus aponte from new york	1
JRI student	jhanisus melendez	1
kachari group	jharua	1
mcci-controlled area	jharkhand	1
mining-dependant state	jharkhand	1
plaaf's modern fighter	jh- seven 	1
village deity	jhind	1
woman heroes	jhalkari bai	1
adivasi dominant area	jharkhand	1
big-ticket writer	jhumpa lahiri	1
camp setting	jhapa camp for bhutanese refugees in nepal	1
corporate and philanthropic board	jhw greentree capital	1
curly perm	jheri-curl	2
custom IEMs	jh audio jh sixteen  pro 	1
dead and worship hindu deity	jhind	1
demeritorious Weighty action	jhanas	1
distinguished attainment	jhanas	1
distinguished attainment	jhaanas	1
name	jhola chap	1
name	jhonny gonzalez	1
name	jhm enterprises	1
name	jhouta khamar	1
name	jhumming	1
fragile freestone peach	jh hale	1
habitation center	jharsuguda	1
haskell compiler	jhc	1
helmet-mounted sight	jhmcs	2
jacketed bullet	jhp	1
karting school	jhrii for starter	1
factor	jh	1
case	jhc	2
maithili community	jha	2
muslim peasant caste	jhojha of western uttar pradesh	1
neuro program	jhu	1
non-ecdysteroidal chemical	jh	2
case	jha subcommittee	1
case	jharkhand	1
case	jhu program in madrid	1
quilt specialist	jhp quilts & antiques	1
right-wing trade union leader	jh thomas	1
top field journal	jhr	1
tribal movement	jharkhand movement in bihar	1
tribal state	jharkhand	2
acclaimed diaspora writer	jhumpa lahiri in the usa	1
association inalarge African-American population	jhs	1
busy trauma unit	jhb hospital	1
coal-bearing state	jharkhand	2
cost-effectiveness analysis	jha	1
CTY campus	jhu homewood campus	1
option	jh- seven 	1
group	jhai foundation	1
local tribal organization	jharkhand human rights organisation	1
loopy font	jheri curls	1
meditative absorption state	jhana	1
metadata-extraction tool	jhove	1
MHVs	jhm  two . two -v- one 	1
micro-watershed development project	jharia nala micro watershed at tileijhar	2
partially unsaturated ses-quiterpenoidsand related structure	jh	1
self-defined filename suffix	jhtml	1
superb Stupas	jhang club chorten	1
technical metadata extraction tool	jhove	1
trend research facility	jhu-applied physics laboratory	1
tool	jhove	4
well-known, regular contender	jhalfrezi	1
tool	jhdl	1
project	jhabua	1
artist	jhaveri sisters	1
artist	jhonen vasquez	1
place	jhansi	2
place	jhilmill	1
place	jhb	1
player	jhonny peralta	2
player	jhonattan vegas	1
player	jhyryn taylor	1
player	jhon kennedy hurtado	1
player	jhoulys chacin	1
system	jha silverlake	1
system	jhove	1
system	jhdl	1
species	jhanna garjan	1
condition	jhds' working condition	1
variable	jhp nine hundred and fourty-seven  gene status 	1
function	jhora	1
site	jhe's log furniture place	1
