exception	kdka in pittsburgh	2
product	kd wawa lumber	1
product	kde	1
client	kdu	1
client	kde kontact	1
alternative	kde	1
agency	kdot	2
structure	kds stomaintain various geometric structure	1
part	kde development platform	1
agent	kd feddersen uebersee hamburg	1
development	kdfx	1
type	kd pool constructed of a durable poly-reinforced tri-laminate fabric	1
feature	kde  four 	1
position	kdp health program manager	2
entity	kddi	1
Organisations	kdf	1
partner	kdot	1
customer	kddi	1
environment	kde	4
software	kde	1
provider	kddi	2
top quality inn	kd's botanical guest house	1
speaker	kdpaine & partners ceo katie paine	1
competitor	kdka	1
brand name	kd tools	1
brand name	kd	1
line	kd river cruises	1
package	kde	3
utility	kde's kppp client	1
university	kdu	1
platform	kde	1
bank	kdb	1
user	kde	1
operator	kddi	3
station	kdka	2
station	kdfw	1
station	kdfc san francisco	1
station	kdka in pittsburgh	1
station	kdka pittsburg	1
station	kdnl	1
upgrade	kde  three rd bearing block 	1
mode	kd- five hundred z's new key custom mode 	1
apps	kde games	2
apps	kde  three . five  desktop window manager 	2
apps	kdevelop	1
apps	kde desktop enviornment	1
competition	kdd-cup  two thousand and seven 	1
college	kdu university college	1
college	kdu	1
government agency	kdwp	1
enhancement	kde desktop environment	1
carrier	kddi	2
popular brand	kd tools	1
issue	kdb	1
mediums	kdf	2
goodie	kde  four . four . five 	1
contemporary	kd lang	1
stuff	kde application	1
code	kdc	1
library	kde library	1
interface	kde	1
interface	kdhe birth records	1
large project	kde project	1
large project	kde	1
manager	kde file manager	1
basic function	kdevelop	1
training	kdp iii training modules formulation workshop	1
radio station	kdwb	3
radio station	kdka	1
radio station	kdge	1
radio station	kdon	1
radio station	kdka-am	1
radio station	kdhx in st. louis	1
radio station	kdhx	1
radio station	kdwn	1
radio station	kdnz	1
student organization	kdic radio station	1
editor	kdevelop	1
browser	kde's konqueror	1
browser	kde konqueror	1
monster	kde	1
file format	kdc	1
inorganic material	kdp	2
TV program	kdoc	2
large-scale project	kde	1
area	kdd	1
datum structure	kd tree	1
predecessor	kd malaviya	1
big project	kde	2
crystal	kdp	1
public entity	kdb	1
fly	kdm rat	1
suite	kdevelop	1
large system	kde office	1
japanese company	kddi	1
user interface	kde	1
international conference	kdc	1
social gathering	kdfc club party	1
private university	kdu	1
mutation	kdr	1
consulting firm	kdm consulting	1
proper tool	kdiag software	1
telecommunication company	kddi	1
innovative project	kde	1
umbrella organization	kde	1
application server	kdc	1
configuration option	kde four 	1
private college	kdu	1
editing tool	kdenlive	1
sophisticated application	kde desktop	1
side project	kdevelop	1
radio show	kdon in salinas ca	1
solution provider	kds	1
service	kddi's fixed-line service	1
service	kddi business call direct	1
technical indicator	kd line	1
toolkits	kdialog	1
national survey	kdhs	1
lunch item	kd dinner	1
topic	kde	1
local station	kdaf tv	1
deployment	kddi in japan	1
IDEs	kdevelop	1
graphical user interface	kde for the installation	1
graphical user interface	kde	1
window manager	kde	6
armor	kds	1
imported item	kds	1
company	kds	2
company	kddi	1
open-source project	kde	3
mobile phone company	kddi corp.	1
terminal program	kde's konsole	1
carbon	kdf	1
email application	kde's kmail	2
file manager	kde file manager	1
company	kddi r&d laboratories	1
company	kdi	1
company	kddi corp.	1
modern browser	kde's kfm	1
talented performer	kd lang	1
network carrier	kddi in japan	1
IDE	kdevelop for use with nasm	1
IDE	kdevelop	1
anisotropic material	kdp	1
cell phone company	kddi	1
cell phone company	kddi corp.	1
e-mail application	kde's kmail	1
wireless operator	kddi	1
desktop environment	kde	66
key stock	kdc	4
source system	kde	1
global operator	kddi	1
communication service provider	kddi	2
advanced datum structure	kd tree	1
GUIs	kde	2
great alternative	kde	1
secretary	kdtib el -  one  nshi 	1
reputable educational institution	kdu college	1
academic conference	kdd	2
cellular provider	kddi	1
CDMA operator	kddi	1
CDMA operator	kddi in japan offer lbss	1
desktop	kde	13
birefringent crystal	kdp	2
configuration tool	kde package manager	1
geometric structure	kds stomaintain various geometric structure	1
windowing system	kde	1
filtration material	kdf resin	2
scientific event	kdbi@epia two thousand and eleven  track 	1
subforums	kde	1
electro-optical material	kdp	1
big stock	kdc	1
commercial radio station	kdka	1
community station	kdhx in st. louis	1
established local artist	kd da beast	1
clinical practice guideline	kdoqi guidelines published by the national kidney foundation	1
destroyer	kd bapuk	1
destroyer	kd teh tarik	1
destroyer	kd calipso	1
event	kdi	1
amazing singer	kd lang	1
expert partner	kdg university college of antwerp	1
graphical system	kde	1
GUI interface	kde	1
inorganic crystal	kdp	1
program	kde	4
non-linear crystal	kdp	1
large software project	kde	1
program	kdm	1
program	kde pim applications kaddressbook	1
OSS project	kde	1
WMs	kde	1
asian operator	kddi	1
command post	kd handalan	1
command post	kd malaya	1
command post	kd lekiu	1
japanese carrier	kddi corp.	1
japanese carrier	kddi	1
PIMs	kde pim	1
program	kde file serverapplet	1
program	kdepim	1
popular open source project	kde	1
appz	kde killer appz	1
desktop manager	kde	1
localization sequence	kdel	2
community	kdumim in northern samaria	1
community	kde	1
publicly available datasets	kdd cup	1
student organizat ion	kdic radio station	1
graphical user environment	kde	1
Installing software	kde	2
loyalist corporation	kdy	1
modern window manager	kde	1
reliable and good brand	kdg	1
rough set application	kdd	1
session manager	kdm	1
urban housekeeper station	kday	1
XDMCP server	kdm	1
XDMCP server	kde display manager	1
organization	kdu college	1
organization	kds	1
Imperial starfighters	kdy a- nine  vigilance 	1
integrable equation	kdv	1
international telephone company	kddi	2
large open-source system	kde	1
spatial access method	kd-tree	1
video processor	kds leeza	1
workspace element	kde workspace element	1
technique	kd-tree	1
technique	kde	1
desktop interface	kde	1
display manager	kdm	1
grantmaking foundation	kdk harman foundation	1
graphic user interface environment	kde	1
heavyweight program	kde konsole	1
KDE dependency	kdeui	1
KDE dependency	kdecore	1
linux desktop environment	kde	2
local traffic service	kdka  one thousand and twenty  am 	1
model equation	kdv	1
nice client	kdu	1
nonlinear integrable equation	kdv equation	1
application	kde	1
application	kdetv	1
application	kdenlive	1
application	kde control center	1
sialic acid	kdn	1
standard deck board	kdm decking board	1
suitable non-linear crystal	kdp	1
application	kdt	1
traditionally strong O&Os	kdka pittsburgh	1
trelleborg standard seal	kdas	1
webdav compliant calendar application	kde korganizer	1
3-deoxy-2-ulosonic acid	kdo	1
acceleration purpose	kd-trees	1
bravia model	kdl thirty-seven ex five hundred and three u 	1
bravia model	kdl fourty ex four hundred and three u 	1
classical ER retention motif	kdel	1
community-driven development project	kdp	1
complete UNIX desktop environment	kde	1
corporate online booking tool	kds	1
default desktop environment	kde	1
desktop environment s	kde	1
desktop GUI	kde	1
Desktopmanagers	kde	1
display managers	kde	1
duplicated gene	kdh e one  paralog genes conserved in kinetoplastid parasite 	1
elaborate desktop	kde	1
female canadian singer	kd lang	1
full desktop	kde  four . two  on a netbook 	1
german competitor	kdg	1
giant datum center service provider	kddi	1
graphical desktop environment	kde	1
heavy gui	kde	1
international call provider	kddi	1
ISO image	kde liveimage from fedora	1
japanese cellular operator	kddi	1
japanese mobile phone provider	kddi	1
japanese operator	kddi	1
case	kddcup  two thousand  	1
linux's desktop environment	kde	1
midlets	kd player	1
modern desktop	kde	1
modern desktop environment	kde	4
multi-symplectic hamiltonian system	kdv equation	1
non-profits and independent organization	kde	1
online travel technology company	kds	1
open-source plug-insforpopular environment	kdevelop	1
OSSprojects	kde	1
case	kdp	1
pretty graphical interface	kde	1
project ritual	kde's regular social event at the annual linuxtag in karlsruhe	1
regional fiber operator	kdl	2
solution many mail system	kde's kmail	1
someemail application	kde's kmail	1
spatial subdivision structure	kd-tree of the point	1
suite playability condition	kdm prerequisite	1
traditional desktop environment	kde	2
UNIX GUIs	kde	1
window system desktop project	kde	2
option	kde's print setup	1
big desktop environment	kde	1
bloated monster	kde	1
categorical package	kde games	1
CDMA operation business	kddi of american sprint	1
challenge competition	kdd cup	2
classical epistemic logic	kd fourty-five 	1
common desktop environment	kde	2
common media	kdf	1
competitive CLECs	kddi corp.	1
completely different desktop environment	kde	1
composite fit model	kdkd	1
C-terminal signal peptides	kdel	1
datum mining competition	kdd cup	1
desktop enviroments	kde de's	1
Desktop environments	kde	1
desktop-oriented system	kde	1
dispersive crystal	kdp	1
endoplasmic reticulum retention motif	kdel	1
entdesktop environment	kde	1
E-O crystal	kdp	1
extremely bloated window manager	kde	1
full-blown desktop environment	kde	1
full-fledged desktop environment	kde	1
graphical CVS client	kde's cervisia	1
iconic lesbian artist	kd lang	1
infinite dimensional system	kdv	1
Integrated toolkits	kde	1
kde module	kdesdk	1
key improvement tool	kdi	1
large and diverse project	kde	1
large scale unix apps	kde	1
large window manager	kde	2
largest mobile provider	kddi	1
linux community	kde	1
linux desktop system	kde	4
linux graphical user interface	kde	1
linux window manager	kde	2
MKP man	kdc	1
modern digital artist	kdu	1
modern GUI manager	kde	1
noncentrosym-metric crystal	kdp	1
method	kd-tree	1
ortantincaseof publicly availabledatasets	kdd	1
popular graphical environment	kde	1
powerful desktop	kde	1
public software application	kdenlive	1
purpose desktop	kde three 	1
quick change tool holder	kdk	1
reknowned college	kdu	1
retention motif	kdel	1
second desktop environment	kde	1
second harmonic crystal	kdp	1
method	kd trees	1
soliton equation	kdv	1
SRI index	kdl research	1
SuSE apps	kde kioslave-audiocd	1
target-site modification	kdr mutation	2
third party music player	kd player	1
top AM station	kdka	1
top quality building product	kd douglas fir	1
up-to-date linux desktop environment	kde	1
tool	kde bluetooth utility	1
virtual desktop environment	kde	1
volunteer-based project	kde	1
wellknowned college	kdu	1
X11 desktop	kde	1
X-Windows Desktop Manager	kde	1
project	kde	11
project	kdp	2
project	kde's khtml in safari	1
artist	kd lang	8
artist	kdj	1
artist	kd aubert	1
artist	kdj calvin tang terry b	1
material	kdp	2
material	kdf resin	1
term	kde	2
parameter	kd	1
system	kde	2
system	kde with the kgpg	1
element	kde workspace element	1
brand	kdk	3
brand	kd tools	2
brand	kdd	2
brand	kd	1
brand	kd tools & jacobs	1
component	kdm	5
