product	kvm	1
product	kvm switches	1
accessory	kvm switch	1
accessory	kvm mounting equipment	1
model	kv- one 	1
word	kvetch	1
form	kvenland in sweden	1
person	kv kamath the driving force behind icici bank	1
alternative	kvm over ip	2
solution	kvm	2
feature	kvm-over-ip remote control	2
part	kvp tap switch	1
school	kv bhel	1
criterion	kvo	1
manufacturer	kvadrat	2
manufacturer	kverneland in the agricultural sector	1
manufacturer	kvar	1
manufacturer	kverneland	1
feature	kvm remote control	1
study	kvam research	1
team	kv racing technology	1
region	kvemo kartli	1
Organisations	kvic	1
show	kville	1
vendor	kvc	1
vendor	kvs	1
department	kvic	1
scheme	kvic margin money scheme	3
award	kvk	1
destination	kvarner	1
image	kvikne altarpiece	1
channel	kv one . five 	1
channel	kv four . two 	1
hotel	kvarner	1
station	kvie in sacramento	1
station	kvue-tv in austin	1
station	kveo	1
input	kvp  eighty-nine 	1
fabric	kvdrat in the colors orange	1
household name	kvd	1
social activity	kvn	1
peripheral	kvm switch	1
item	kvm switch	1
beverage	kvass	6
hardware	kvm switch	1
quality brand	kv two  sound systems 	1
radio station	kvoo	2
radio station	kvcu	1
radio station	kvno	1
stalwart	kv thangkabalu	1
well-known company	kvadrat	1
well-known company	kv supply	1
lubricant	kvd	1
peripheral device	kvm switch	1
community partner	kvmr radio	1
spec	kv	1
minority group	kven person	1
tank	kv	2
tank	kv- one 	1
acquisition	kvaerner pulping	1
switch	kvm switch	1
pharmaceutical company	kv pharmaceuticals	1
hardware component	kvm switch	1
area	kvarner riviera	1
supermarket chain	kvickly	1
spelling	kvam	2
liquid product	kvass	1
service	kvs tool	1
system characteristic	kv	1
design characteristic	kva capacity	1
open source technology	kvm	1
key person	kvp	1
conditioner	kvd line conditioner	1
topic	kven clothing	1
police agency	kvet in kalamazoo county	1
virtualization technology	kvm andvmware	1
virtualization technology	kvm	1
engineering firm	kvaerner power gas	1
company	kvaerner	2
company	kvh	2
investment instrument	kvp's	1
virtualization solution	kvm	2
subunits	kv three . three 	1
subunits	kv one . six 	1
subunits	kv four . one 	1
third party device	kvm switch	1
company	kvg	1
company	kvadrat	1
company	kv vet supply	1
company	kvichak marine industries in ballard	1
company	kvs inc.	1
company	kv pharmaceutical	1
ion channel	kv one . five 	2
ion channel	kv one . one 	1
ion channel	kv one . two 	1
local non-profit group	kvnf public radio	1
exposure factor	kvp	2
exposure factor	kv	1
language program	kvoctrain for vocabulary training with flashcard	1
pagan god	kvasir	1
accessory protein	kv channel beta subunits	1
source device	kvl	1
financial institute	kvib	1
financial institute	kvic	1
local search engine	kvasir	1
hypervisors	kvm	1
weld parameter	kva process-specific weld parameter	1
flow information	kv value	1
heavy tank	kv one 	1
third party inspection agency	kvg	1
liquid security	kvp	2
traditional family favorite	kvass	1
exposure datum	kv p	1
virtualisation technology	kvm hypervisors	1
information	kv figure	1
ancillary requirement	kvm switching	1
small saving scheme	kvp	2
host information	kvm version	1
information	kva of the unit	1
information	kv	1
police group	kvp	1
continuous control	kv ar	1
evening newspaper	kvallsposten	1
mainstream vendor	kvaerner	1
simple law	kvl	1
kvm switch	kvm cable switch	1
public television station	kvie	1
cross-border case	kvaerner	2
good compass	kvh	1
program	kv ladder builder for windows	1
jesse viertel memorial airport	kver	0
x-ray parameter	kv	1
yiddish word	kvetch	1
basic electrical concept	kva rating	2
local new station	kvue	1
voltage-gated potassium channel	kv one . two 	3
voltage-gated potassium channel	kv one . one 	1
voltage-gated potassium channel	kv one  . two 	1
voltage-gated potassium channel	kv one . five 	1
voltage-gated potassium channel	kv one . six 	1
factor	kv	1
iconic business leader	kv kamath	1
local television program	kvos bellingham-vancouver	1
runic inscription	kvinneby amulette	1
top consultant	kvaerner powergas india ltd.	2
well-established construction material	kvh	1
best pharmaceutical company	kv pharmaceuticals	1
foremost pharmaceutical company	kv pharmaceuticals	1
matchless pharmaceutical company	kv pharmaceuticals	1
organization	kvh co.	1
organization	kvindelige arkaeologer i norge	1
pre-eminent pharmaceutical company	kv pharmaceuticals	1
reliable system maintenance function	kvm over ip	1
severalvirtualization solution	kvm	1
unrivalled pharmaceutical company	kv pharmaceuticals	1
advanced RMM3 feature	kvm redirection	1
CROSSTALK many system	kvm switch	2
ethnic minority region	kvemo kartli	1
large overseas investor	kvaerner	1
markedly extemporaneous program	kvn	1
mind subunits	kv	1
misc device	kvm over ip	1
obsolete test	kveim test	1
premium tank	kv five 	1
application	kvm extension	1
traditional and new color	kvaerner	1
virtu-alisation technology	kvm hypervisors	1
voltage-gated channel	kv one . two 	1
world-renowned football club	kv madrid	1
circuit method	kvl	1
discount catalog	kv vet supply	1
extension agency	kvic	1
name	kvelertak	1
name	kvar	1
full out-of-band management tool	kvm over ip	1
heathen author	kveldulfr gundarsson in teutonic religion	1
heathen author	kveldulf r gundarsson in teutonic religion	1
high-tech event facility	kvm system	1
low end model	kv seven 	1
modem-enabled device	kvm-over-ip switch	1
open source hypervisors	kvm	1
open-source virtualization technology	kvm	2
out-of-band component	kvm switch	1
power measurement datum	kvar	1
radiography parameter	kv	1
raw fermented drink	kvass	1
regal hotel	kvarner	1
T5 tank	kv	1
volumetric verification technique	kv cone-beam ct	1
3rd party archiving system	kvs	2
option	kvh satellite tv	1
campus orginizations	kvrx	1
causal independence proposal	kvart  one thousand nine hundred and eighty-six 	1
commercial successful director	kv anand	1
option	kvm switch	1
option	kv	1
examination technique exposure factor	kv	1
fermented and healthy soda	kvass	2
high quality scanner	kv s four thousand and eighty-five cl 	1
human kv10 subfamily member	kv ten . one 	1
Kv channel subtypes	kv four . two 	1
kv1 channel	kv one . two 	2
kv1.x channel	kv one . four 	1
KVM device	kvm console module	1
KVM solution	kvm wizard	1
legendary tank	kv	1
non-alloyed steel	kv ten 	1
non-clustered channel	kv one . four 	1
potassium channel unit	kv two . two 	1
professional microphone adapter	kv connection iphone microphone adapter for higher-quality audio recorded in a noisier environment	1
real-time web feature	kvvu las vegas pump patrol , wicz binghamton	1
method	kvarh billing	1
method	kvaerner carbon black & hydrogen process	1
Silent channel subunits	kv eight . one 	1
sport pad	kvr	1
traditional device access tool	kvm switch	1
trumpeter kit	kv- one 	1
user spacevirtualization solution	kvm	1
voltage-sensitive potassium channel	kv one . five 	1
tool	kvs	1
tool	kvs tool	1
material	kv	1
player	kvb	2
player	kvh industries purchase of virtek sa	1
technology	kvm	2
product	kv meter	1
product	kvm cable	1
parameter	kv	5
parameter	kva process-specific weld parameter	1
component	kvm's	1
site	kvr audio for news on recent creation	1
