facility	ljubljanksa banka	1
product	lj shopping bags	1
exception	ljubo madzar	1
character	lj	1
institution	ljmu	1
agency	lj hooker	2
book	lj smith book	1
star	ljungberg	1
business	lj hooker castle hill	1
city	ljubljana	11
city	ljubljana in slovenia	1
town	ljubljana	3
drug	lj steroid drug	1
study	ljunavustand uhlig	1
website	lj	1
figure	ljn toy	1
big name	ljubicic	1
designer	lj designs	1
designer	ljm	1
party	ljp	1
competitor	lj hooker	1
legend	ljungberg	2
festival	ljubljana festival	1
festival	ljubljana international film festival	1
festival	ljubljana international film festival liffe	1
car	lj torana	1
university	ljmu	2
supplier	lj smith	1
modification	ljungman	1
sight	ljubljana castle	1
novel	lj smith novel	1
oil	lj use cold-pressed organic oil	1
center	ljubljana	1
local business	lj hooker castle hill	1
photographer	ljalja kuznetsova	1
candidate	ljubo milicevic	1
candidate	ljubo milecevic	1
notable exception	ljr reba  two hundred and eleven l 	1
developer	ljn	1
economist	ljubomir mazdar of belgrade university	1
blogs	lj	1
winner	ljubicic	1
franchise	lj hooker	1
outfit	lj	1
big city	ljubljana	1
partnership	ljmu isc	1
area	lj	1
travel spot	ljubljana	3
predecessor	lj johnson	1
logo	ljg	1
issuer	lj	1
meta datum	lj's mood	1
newsletter	lj hotline	1
mind	ljiljana dobrich from east hamilton	1
cultural center	ljubljana	1
year player	ljungberg	1
investment fund	ljm	1
communication resource	lj	1
organic oil	lj use cold-pressed organic oil	1
company	ljn toys	1
big town	ljubljana	2
company	ljn	1
magnificent city	ljubljana	5
diagnostic statistic	ljung-box test	1
compatible program	lj manager	1
steroid drug	lj steroid drug	1
principal town	ljubljana	1
real estate agency	lj hooker	1
standard statistical test	ljung-box test	1
communist city	ljubljana	1
digital graphic	lj layout	1
cold-pressed organic oil	lj use cold-pressed organic oil	1
structured surface	lj bottom panel of fig	1
world class grandmasters	ljubomir ljubojevic	1
plausible threat	ljubicic	1
organization	ljic in montana	1
ATP player	ljubicic	1
charming smaller city	ljubljana	1
desperate last minute free transfer	ljubo milicevic	1
fannish art	lj icon	1
international real estate agent	lj hooker	1
izetherelevantdenitions	ljapunovexponent	1
nice austrian-type town	ljubljana	1
player FSCG montenegro	ljubomir radanovic	1
scheduling framework	ljf	1
SPEs	ljm one 	3
air preheater	ljungstrom regenerative air heater	1
big, well-resourced group	lj hooker	1
name	ljupko petrovic	1
car-oriented city	ljubljana	1
dierent scheduling framework	ljf	1
established restaurant group	ljc group's fely j	2
furry site	lj community	1
russian diva	ljuba petrova	1
text-based site	lj	1
appropiate name	lj four l for laserjet  four l before clicking ok 	1
legal agent	lj kane	1
maintenance side	lj	1
sector-wide support mechanism	ljss in png	1
method	lj proportion	1
software's development	lj digital libraries blogger roy tennant	1
witnesses-collaborators	ljubisa buha cume	1
project	lja discovery program	1
place	ljubljana	1
player	ljungberg	3
player	ljubicic	1
player	ljajic	1
system	lj fluid	1
brand	lj apparel	1
brand	lj pratley & partners	1
brand	lj talk	1
site	lj	1
