character	lk hamilton's anita blake	1
person	lk	1
book	lkh's anita blake book	1
title	lke weekend	1
dish	lkan rakar muara	1
leader	lk advani	1
partner	lkm technology's vendor partner	1
section	lkr	1
label	lk bennett	1
capability	lkfs audio loudness meter	1
retailer	lk bennett	2
party	lkck from the assembly	1
guest	lk	1
key item	lk elsinore economic	1
key item	lk forest pk economic	1
neighborhood	lk frederick	1
supplier	lkm	1
interest	lking	1
politician	lk advani	1
gene	lkb one 	2
airline	lkm	1
local company	lkh auto sales	1
item	lk barrington property tax	1
comment	lkuoew watch movies online whcceow day-to-day	1
transcription factor	lklf  eleven 	1
dynamic	lkp	1
train	lkm	1
classic favorite	lk bennett	1
senior leader	lk advani	1
company	lk bennett	1
top store	lk bennett	1
encounter	lk hc	1
vendor partner	lkm technology's vendor partner	1
seasonal festival	lkf street carnival	1
carrier protein	lkt	1
TLDs	lk for sri lanka	1
information	lka	1
english brand	lk benett	1
high-street brand	lk bennett	1
high street favorite	lk bennett	1
event	lks bbq	1
military small arm	lkp- sixty-six  sporting rifle 	1
military small arm	lkp- ninety-six  machine gun 	1
muslim business	lks jewellers	1
organization	lk bennett	2
strategic home automation partner	lk schneider	2
respected women's clothing store	lk bennett	1
mold standard	lkm	1
PAP old guard	lky	1
name	lk inc.	1
name	lk	1
front line fashion name	lk bennett	1
Sinhala Unicode font	lk-lug font	1
anti-recallists	lka	1
blac patent accessory	lk bennett peony bag	1
black envelope clutch	lk bennett's mayfair clutch	1
expensive module	lkm	1
Guided democracies	lky's singapore	1
project	lkim swimming pool	1
player	lk	1
system	lkca  fifteen 	1
condition	lks	1
brand	lk bennett	6
