initiative	mheg interactivity	1
initiative	mha keystone project	1
initiative	mht	1
initiative	mhs	1
datum	mhs	2
source	mhs peo	1
exception	mhra safety exception	1
model	mhd	2
institution	mha	1
client	mht lighting	1
client	mhhp for the nhs in the public sector	1
document	mht	1
product	mhp's t-bomb ii	1
strategy	mhc gene	1
agency	mhra	2
agency	mhs	1
agency	mha	1
agency	mhmr case management	1
mechanism	mhc class i augmentation	1
solution	mheg	1
business	mha	1
field	mh type	1
field	mhd	1
school	mhs	1
requirement	mhtr cause delay	1
favorite	mh varsity in cord	1
manufacturer	mhi	1
class	mhs	1
class	mhc	1
position	mhs cu coordinator	1
individual	mhr biology politician	1
unit	mhz	1
region	mhddad region  five 	1
format	mhtml	2
format	mh folder	1
Organisations	mhlc	1
standard	mhp	1
standard	mheg	1
vehicle	mhu- eighty-three  bomb lift truck 	1
environment	mhp	1
module	mhc	1
magazine	mhq	2
magazine	mh- eighteen 	2
magazine	mheda edge	1
magazine	mheda journal	1
protein	mhc class ii	2
protein	mhc protein	1
protein	mhc ii	1
competitor	mhi	1
stakeholder	mhsc	1
journal	mhdd mhdd mental health	1
line	mhz range two-conductor line	1
channel	mh pulse intranet	1
limitation	mhe	1
station	mhat- nineteen  in morgan hill 	1
singer	mhairi lawson	1
mode	mh mode	1
authority	mhra	2
authority	mhlw	1
input	mhp	1
gene	mhc haplotypes	2
gene	mhc	1
gene	mhc class i	1
regulation	mhlw approval in japan	1
electronic device	mhz consumer electronic device	1
giant	mh- fifty-three 	1
aircraft	mh- sixty  daps 	1
establishment	mhi communications	1
quantity	mhd turbulent heating rate	1
code	mhd equilibrium code	1
critical issue	mhd stability	1
hospital	mhb	1
ministry	mhr	1
great artist	mhk	1
conference	mhealth summit	1
answer	mhr	1
legislation	mhsa	1
apparatus	mhd pump	1
funding source	mh fa	1
winner	mhj	1
system component	mhhnovotegra mounting rail	1
degree	mha	1
multinational	mhe dematic	1
venture	mh systems	1
light	mh	5
advanced function	mhd stabilization	1
ligands	mhc class i	1
nonprofit	mhs	1
spec	mhz	1
area	mhluzi extensions	3
analysis technique	mhd approach of cheng	1
regulatory agency	mhra in the uk	1
grant	mhec-brac grant	1
industry expert	mhealth pioneer welldoc	1
host factor	mhc type	3
area	mhlambanyatsi river	1
area	mhi	1
reputable brand	mhs	1
shopping centre	mhcc located in central suva city	1
site feature	mhfa course catalog	1
appointment	mhow	1
genetic factor	mhc haplotype	2
genetic factor	mhc-encoded gene product	1
reading	mhz	1
area	mhe	1
biological material	mhv-infected biological material	1
populated area	mhi	1
lamp	mh	1
factor	mha	1
factor	mhc binding affinity	1
factor	mhc revenue	1
recording device	mhp video recorder	2
national tenant	mhc cosmetics	1
wheel	mht luxery wheels	1
membrane protein	mhc class ii	1
membrane protein	mhc ii	1
commercial system	mhealth hardware	1
classic song	mhaire bhan og	1
consortium	mhealth alliance	1
regulatory authority	mhra	2
service	mheg datum	1
young gun	mhonga ruanywa	1
RNA virus	mhv	1
interesting application	mhd	3
topic	mhd instability	2
topic	mhs performance planning pilot	2
glycoproteins	mhc molecule	1
school organization	mhs amnesty international	2
topic	mhc	1
consumer electronic device	mhz consumer electronic device	1
industrial town	mhlume	1
specialty project	mhmra conference center	1
local dignitary	mha darin king	1
HD channel	mhd	1
candidate gene	mhc gene	1
millionaire	mhamad al fayed	1
japanese manufacturer	mhi	1
surface molecule	mhc class ii	1
surface marker	mhc ii	1
company	mhs	2
company	mhi	2
great school	mhs	1
aviation company	mhi	1
transmembrane protein	mhc i	1
cell surface receptor	mhc class ii	1
common abbreviation	mhz	1
white light source	mh	1
company	mhlume	1
global supplier	mhi	1
guidance document	mhra good pharmacovigilance practice guide	1
master's degree	mha	2
activation marker	mhc ii	2
activation marker	mhc class ii	1
wildlife sanctuary	mhadei	1
cell surface marker	mhc class ii	1
e-mail system	mhs-based e-mail system	1
educational option	mhlt's woodland progressive charter school	1
closers	mhs	1
differentiation marker	mhc	1
experimental issue	mhd	1
lifter	mhp president gerard dente	1
reservoir property	mh saturation	1
allele	mhc class ii allele	1
competent authority	mhra	1
farming community	mhangura	1
battery charger	mh-c two hundred and four w 	1
battery charger	mh-c four hundred and one fs 	1
battery charger	mh-c four hundred and ninety f battery chargers 	1
battery charger	mh-c two hundred and four f 	1
fresh seafood	mhi mahi dish	1
invoice	mhs alarms	1
national database	mhi's community attributes system	1
renderers	mhtml	1
cell surface antigen	mhc class i	1
common phenomenon	mhd instability	1
high intensity discharge lamp	mh	1
parochial school	mhs	1
successful client	mh hoejgard	1
contractile protein	mhc	2
reliability measure	mhe	1
signature character	mhenlo	1
upper-layer protocol	mhs	1
information	mhsaa rule change	1
construction process	mhe operation	1
efficient light source	mh	3
government regulator	mhra	1
maritime technical term	mhws	1
normal product	mh	1
ags	mhc class i-restricted tumor ags	1
high-intensity discharge lamp	mh	1
male magazine	mh targeted at succesfull man	1
quantitative assay	mhc tetramer	1
inhibitory receptor	mhc-recognizing inhibitory receptors expressed on nk cell	1
plasma application	mhd power generation	1
event	mha golf tournament	1
program	mh	3
supporting mod	mhg	1
african great	mhotella queens	1
challenging assignment	mhs	1
coronaviruses	mhv	4
insurance panel	mhn	1
program	mhp program	2
program	mhc simulator	1
beat maker	mhe	1
encapsulation	mhtml	1
mountain resource	mhs & rotw.net	1
national regulatory authority	mhra	1
small helicopter	mh- six 	2
ifn-inducible gene	mhc gene	1
printable window file	mhtml	1
bright lighting	mh	1
factor	mhc haplotype	1
factor	mhc-specifictranscrip-tionfactorsand  general factor	1
high intensity light	mh	1
non-locals	mhd	1
osteoporosis-associated gene	mhc	1
unit s	mhz for frequency	1
worst-affected area	mhardeh in hama governorate	1
advanced development	mhd technology	1
Beatmakers	mhe	1
CoV	mhv	1
entropy coding method	mh coding method	2
intense lighting	mh	1
layered model	mh-model with less discrete stage	1
organization	mhpcc	1
organization	mh mobile group	1
organization	mhealth initiative	1
Strong lighting	mh	1
supporting helicopter	mh- fourty-seven 	5
text character	mhz	1
urban unit	mhasla	1
country agency	mhra	1
effi cient light source	mh	1
exosome-proteins	mhc molecule	2
gulf recruiter	mh alshaya	1
HMO insurance	mhn	1
immunologically important molecule	mhc class ii	1
leading healthcare industry expert	mhealth avant-garde welldoc	1
application	mhz band application	1
NYC breakthrough player	mhet vergara	1
obsolete metric unit	mho	1
presentation language	mheg- five 	1
purpose standard	mheg	1
speaker selection command	mht	1
traditional multi-target tracking algorithm	mht	1
transport helo	mh- six 	1
typical functional membrane protein	mhc class ii	1
Activation-associated cell surface Ags	mhc class ii ag	1
antitreponemal antibody test	mha-tp test	1
big helicopter	mh- fifty-three 	1
application	mh lighting	1
cantonment	mhow	1
cell surface maturation marker	mhc-ii	1
coronavirus	mhv	1
CoVs	mhv	1
digital TV standard	mhp in europe	1
gas lamp	mh	1
genetic marker system	mhc diversity	1
genuine, consumer-focused local retailer	mh alshaya	1
government agency inspection	mhra	1
handling inspection	mhra	1
image code	mh	1
immune gene	mhc	1
immune system-related gene	mhc	1
immunologically relevant molecule	mhc class ii antigen	1
influential political actor	mhl w	1
key contractile protein	mhc	1
limita tions	mhe	1
MHP television device	mhp set-top boxes	2
multidimensional instrument	mhlc	1
naval helicopter	mh- sixty r 	1
navy fleet platform	mh- sixty r 	1
navy fleet platform	mh- sixty s 	1
neurotransmitter metabolite	mhpg	1
case	mhd generator	1
case	mh	1
project related file	mhs	1
Proven rotary-wing aircraft	mh- sixty 	2
rotary and fixed-wing aircraft	mh- fifty-three 	1
second, advanced power recovery system	mhd	1
succeeding change	mhc class ii up-regulation	1
case	mhc financing ltd.	1
case	mhc class i	1
survival obstacle	mh wall of fame	2
top stud	mh qaa	1
well-documented mechanism	mhc class i down-regulation	1
adaptive marker	mhc	3
antigen-presenting molecule	mhc molecule	1
option	mh geist	1
characterization circuitry	mhcro  three hundred and two 	3
clark's dealer	mhs	1
classical MCMC method	mh	1
confidentiality law healthcare reform law	mhpa	1
datum association scheme	mht	1
DIF procedure	mh procedure	1
drug regulator	mhra	1
DVB system	mhp	1
expensive tent	mh satellite	1
fitness-related gene	mhc	1
great african classic	mhudi by sol plaatjie	1
high-cct source	mh	1
histocompatibility complex molecule	mhc class ii	1
hybrid unit	mho per cm	1
Identity-markers	mhc	1
image compression file	mh file	1
immune recognition molecule	mhc class ii	1
group	mha rural council of administrators	1
Interactive television terminal	mhp terminal	1
interactive TV system	mhp	1
key global conference	mhealth summit	1
lap-specific alteration	mhc-ii upregulation	1
leukocyte receptor	mhc protein on antigen presenting cell	1
manycoronaviruses	mhv	1
MH game	mhfu	1
mheg-specific component	mheg client	1
non-allowable code	mh	1
nosewheel gear configuration	mh- fifty-three 	1
nuclear plant manufacturer	mhi	1
Open-standard middleware	mhp	1
ouse communication channel	mh pulse intranet	1
personal health portal	mhv	1
pig disease	mhd	1
popular fleece	mh windstopper	1
potential B-NK ligands	mhc class i	1
presentation-oriented hypermedia format	mheg- five 	1
risis program	mhs mobile crisis team	1
second, donor antigen	mhc class i	2
second, genetic factor	mhc haplotype	1
sequential encoding method	mh	1
shorter-range helicopter	mh- sixty s 	1
specialist van insurer	mhia - cil	1
Standard broth	mhb	1
standardized communication code	mh	1
standardized middleware	mhp	1
third, genetic factor	mhc haplotype	1
transplantation antigen	mhc i	1
vinyl cutter	mh  seven hundred and twenty-one  off of uscutters 	1
virus-relevant gene family	mhc class iand ii	1
W193D benefit	mheg five  for interactive service 	2
well-characterized DC marker	mhc class ii	1
factor	mhc genotype	1
factor	mhp presence	1
factor	mhc mismatching	1
factor	mhc-binding affinity	1
project	mhp	1
material	mhv-infected biological material	1
place	mhp-chat mailing list	1
player	mhi	1
technology	mheg- five  ic 	2
technology	mhd	1
term	mhz	1
system	mh- ninety-seven  autopilot 	3
system	mhp	1
system	mhs-based e-mail system	1
variable	mh	2
product	mhe	1
product	mh lamp related product	1
variable	mhc expression level	1
function	mhc class i antigen processing	2
device	mhz consumer electronic device	1
aspect	mhd stability aspect	1
site	mh village	1
