resource	oolite satellite resource site	1
facility	oo-alc	1
process	oocyte activation	3
process	ooda loop	1
game	ooze	1
game	ooh aah dracula r.i.peater	1
game	ooga booga	1
subject	oop	1
product	oos	1
reason	oop artifact	1
character	oocyte diameter	2
character	oor wullie	1
character	oona	1
character	ooyay the blue dog	1
character	oor wullie humor comic character	1
character	ood	1
characteristic	oocyte size	1
word	oocyst	1
word	oolith	1
word	ooey-gooey	1
attraction	ooty lake	1
situation	oocyte maturation in vitro	1
situation	ootw	1
client	ooma	1
document	ooo	1
product	oomf booster	1
product	oola pakkuvada	1
product	oolong chinese tea related product	1
strategy	oocyte	1
person	oophorectomize personally	1
person	ootp development person	1
approach	oohdm	2
approach	oo design approach	1
approach	oo-rpc middle ware approach	1
idea	oo approach	1
idea	oo	1
idea	oop	1
effect	oocyte quality	1
symptom	oozing of fluid	1
symptom	oozing yellowish discharges from the ear	1
symptom	oozing patch	1
symptom	oo cause symptom	1
course	oop	1
course	ooad using uml	1
location	ooh la lane	1
writer	oodgeroo noonuccal	1
writer	oosthuizen	1
action	oom demand reduction action	1
mechanism	oop	1
book	ood with applications	1
book	oo book	1
structure	oolichan drying rack	1
business	oona's restaurant	2
field	ooad	1
procedure	oophorectomy	2
procedure	oocyte freezing	1
band	ooklah the moc	1
amenity	oodles of storage space	1
ingredient	oolong tea extract	3
ingredient	oolong tea	1
plant	oonopsis	1
development	oo	1
type	oolong	1
city	oostburg	1
disease	oomycosis	2
town	ooty	1
favorite	ood	1
complication	oozing from the puncture site	1
class	ooey gooey science	1
class	ooh la la lap dance	1
website	oodle	8
basic	oop	1
musician	oona	1
movie	oops	1
song	ool	1
song	ooh n love	1
improvement	oos battles being improved	1
region	ootsa lake	1
variety	oolong	3
variety	oolong tea from thailand	1
variety	oooh darjeeling	1
animal	oolong	1
classic	ooo baby baby	1
piece	ooak altered art decorator bottle	1
show	oohlala , two thousand and nine  l'oreal fashionweek for carlie wong 	1
show	oobi	1
vendor	ooma	1
influence	oozing down tuned distortion of acid bath	1
critic	oona hathaway	1
effort	ooda loop	1
feature	ooze	1
feature	oozing blood	1
feature	ootb cwqp feature	1
scheme	oodingandgossip-based relaying	1
environment	oo development environment	1
environment	oop-based development environment	1
designer	ooh la la couture	1
magazine	oor	1
retailer	ood cigar retailer	1
retailer	oooh la la	1
destination	ooty	2
party	oocyte donor	1
protein	ookinete surface protein	1
competitor	oodle	1
issue	oom crashes	1
issue	oo programming	1
state	oop state	2
variation	ooi in malaysia	1
variation	oolong tea	1
flavor	oolong tea	1
language	ooo basic	1
language	oohdm	1
neighborhood	ooltewah	1
package	ooty family package	1
friend	ooi eng aun	1
tourist attraction	ooty	1
track	oodnadatta	2
track	ooh la la	1
track	oowee baby	1
theory	ooda loop	1
platform	oovoo	1
platform	oo technology environment	1
composer	oottukkadu venkata kavi	1
domain	oo	1
domain	oo design	1
arrangement	ooking airfare	1
organism	oomycetes	1
medium	oor magazine	1
mode	ooc	2
apps	oovoo	1
factor	oocyte brooding	2
target	oocytes	1
museum	oostends historical museum the plate	1
resort	ootacamund	1
creature	oozes without leg	3
creature	ooze	3
cell	oocytes	12
cell	oorganisms reproductive cell	1
advanced topic	oop in php five 	1
natural ingredient	oolong tea for oxidizing the fat molecule	1
layer	oo layer with different oo attribute	1
dessert	ooey gooey brownie	1
drink	oolong	2
practical issue	oocyte storage	1
hit	ooku	1
pioneer	ooi hwa	1
natural material	oosik	1
natural material	oolong tea by extraction	1
fun activity	oobleck	1
municipality	oostende	2
habitat	oosterschelde in the netherlands	1
qualification	ood underway	1
race	ood	1
genus	oocystis	1
fundamental	oo concept	1
surgical procedure	oophorectomy	4
sound	oooha	1
framework	oohdm	1
port	ool	1
pathogen	oomycete plant pathogen	1
message	oof message	1
tissue	oocytes	1
entree	oolong marinated sea bass	1
office	oos	1
urban area	oosterdokseiland	1
installation	ooo	1
conference	oopsla	1
painting	ooluptuary drozd di!colletage	1
entry	ood s	1
sample	oocyte	1
natural disaster	ood	1
beverage	oolong tea	3
private company	oops pompage septique	1
extension	oop database extension	1
convention	ooma lounge	1
tree species	ooline cadellia pentastylis	1
product category	oolong tea	1
microorganism	oomycetes	2
microorganism	oocysts of cryptosporidium	1
cell type	oocytes	1
modern technology	oo	1
settlement	oodnadatta	1
fundamental issue	oocyte donation	1
place name	oostburg	1
place name	oostmalle	1
achievement	oonagh maccool	2
description	oologist	1
computer program	oop system	1
creation	oogie boogie	1
creation	ooak egyptian cleopatra	1
creation	ooak monster high	1
locale	ooty	1
tune	ooh la	1
bait	oolichons	1
post	ooc post	1
parasite	oodinium pillularia	1
pathology	oophoritis	1
advocate	ooss looking out for the interests of good patient care	1
neighbor	oodles of top local executive	1
invasive procedure	oocyte retrieval for ivf	1
great brand	oopsy daisy	1
growth factor	oocyte-derived growth factor	1
monster	ooze	1
thing	ooey gooey good thing	1
invertebrate	ooze	1
tourist spot	ooty	1
tourist spot	ooty lake	1
web service	oovoo	2
clinical sign	oozing from the site of an intravenous line	1
surprise	ooh la la	1
sweet	ooey gooey brownies	1
bag	ooze tubes	1
medical procedure	oophorectomy	1
occurrence	oolitic limestones with a crystalline groundmass	1
heavy hitter	ootp heavy hitter	1
minor character	oona	1
tea	oolong	38
tea	oolong tea	25
tea	oolong & pu-erh	1
electrical appliance	ooo vacuum cleaner	1
autoimmune disease	oophoritis	2
discovery	oort cloud	2
golf course	oosterhoutse golf club	1
amino acid	oocyte	1
travel spot	oostende	1
sect	oorugolla	1
programming language	oops	1
star hotel	ooty villa park	1
reserve	oolambeyan np	1
diagnostic method	oocyst count	1
herbal tea	oolong tea	2
herbal tea	oolong	2
area	ootsuchi town	1
area	oodi	1
area	ooa ood oop	1
area	ooak clothing	1
area	oosterparkbuurt	1
area	oo reuse -metric	1
local community	oosthuizen	1
paradigm	oo	2
paradigm	oop	1
benchmark	oo seven 	1
anime	ookiku furikabutte	1
rare item	oop hitchcock criterions	1
blend	oolong	1
hitter	ootp heavy hitter	1
service	oovoo	6
exotic location	ooty in india	4
simple ingredient	oolong tea	1
healthy ingredient	oolong tea polyphenol	2
microbe	oomycetes	1
campus activity	oozeball	1
biological system	oocytes	1
international conference	oopsla	1
principal	oocl	1
tourist place	ooty	3
surgical intervention	oophorectomy	1
surgical intervention	oophorectomy in breast cancer	1
famous character	oompa-loompas	1
pilot	ooryl qrygg	1
scavenger	ooze	1
morphological characteristic	oogonial structure	1
leaf	oolong	1
desktop application	oovoo	1
factor	oocyte activation	1
factor	oocyte maturation	1
factor	oocyte-derived growth factor	1
service	ooma voip service	1
family favorite	oobi	1
simulation	oos	1
good fat	ood stuff in avocado	1
aggregators	oodle	1
common procedure	oocyte transfer	1
difficult topic	oo concept	1
diagram	ooa static and dynamic diagram	1
soft drink	oolong tea	1
international corporation	oocl	1
good book	oosc by bertrand meyer	1
surrounding community	ooltewah	1
internet tool	oovoo	1
epic	oob	1
modulation scheme	ook	2
development environment	oo development environment	1
development environment	oop-based development environment	1
sedimentary structure	oolites	1
great flavor	oolong	1
interesting flavor	oolong milk tea	1
shipping company	oocl	1
service	ooma	1
valley	ootsa lake	1
modulation technique	ook	1
parasitic disease	oodinium sp.	1
ambitious project	ooma	1
morphological parameter	oocyte maturation stage	1
latest technique	oop	1
breeder	ooyama koi farm	1
discounter	ooo torgovy dom kopeyka	1
party theme	ooh la la day spa	1
complex technology	oo	1
unforgettable character	oompa loompas	3
slot game	ooga boogah jungle	1
search service	oodle	2
weekly theme	ooey gooey science	1
popular tourist spot	ooty lake	1
topic	oo design	1
topic	oop	1
topic	oop with vb	1
topic	ooc suggestion	1
voip service	ooma	1
physical agent	oophoritis	1
bear	oopsy bear	1
lineage	oocytes	1
plant pathogen	oomycete phytophthora infestans	2
plant pathogen	oomycete plant pathogen	1
interpretation	ooids	1
legendary character	oor wullie	1
modulation method	ook	1
success	oose a ssessment hunter success	1
placement	ooh medium placement	1
shipping line	oocl	3
green alga	oocystis lacustris	1
hill station	ooty	11
hill station	ootacamund in the western ghats	5
hill station	ootacamund	1
tough topic	oo design issue	1
boutique brand	oopsy daisy art	1
experimental procedure	oocyte	1
ranch	oo in arizona	1
voip provider	ooma	2
complicated model	oosterschelde model	1
famous resort	ootacamund	1
fat burner	oolong tea	1
topic	ool	1
topic	oos	1
company	oovoo	3
company	ooh animation	2
service type	oosh service	1
comic character	oor wullie humor comic character	1
conceptual model	oo software model	1
green tea	oolong	2
interesting town	ootmarsum	1
interesting town	ootmarsum nl	1
protozoan parasite	oocysts	1
modulation format	ook	1
body structure	oocytes	1
prominent woman	oona king	1
design approach	oo design approach	1
loop	ooda loop	1
laparoscopic procedure	oophorectomy	1
oily food	ooligan grease	1
reputed hotel	ooty bar restaurant & hotel	76
micro organism	oocysts	1
private contractor	oops pompage septique	1
water project	oodwater storage	1
black tea	oolong	1
human cell	oocytes	1
notable attraction	oosterschelde dam	1
company	ooma	1
big carrier	oocl	1
decision-making tool	ooda loops	1
beach city	oostende	1
odd exception	ool	1
alarm condition	oof	1
company	oocl	1
company	oomingmak knitters collective	1
online marketplace	oodle	1
process technique	ooda loop methodology	1
ghost	oona king	3
global carrier	oocl	2
traffic type	oob traffic	1
hilly area	ooty	1
national and international conference	oopsla	2
negative term	oollldd people	1
key witness	oocl employee	1
non-newtonian fluid	oobleck	1
programming paradigm	oop	2
tourism area	oodnadatta track	1
interior city	ootacamund	1
netherland tv channel	oog tv	1
organ-specific autoimmune disease	oophoritis	1
assisted reproductive technique	oocyte transfer	1
negative change	oozing skin	1
non-carbonated drink	oolong tea	2
phytopathogenic fungus	oomycetes	7
factor	oocytes on the day of oocyte retrieval	1
factor	oolemma characteristic	1
factor	oos status	1
surface protein	ookinete surface protein	1
classified site	oodle	2
voip service provider	ooma hub	1
genetic issue	oocyte aging	1
secondary lesion	oophoritis	2
abiotic component	ooids	1
browser extension	oomph for internet explorer	2
computer science topic	oop	1
global shipping company	oocl	1
graphic designer	ootje oxenaar	1
implementation technique	oo programming language	1
implementation technique	oo database technology	1
parasitic organism	oodinium	1
tea product	oolong tea	1
picturesque spot	ootmarsum	1
tea leaf	oolong	4
latest application	oovoo	1
continuous measurement	oocyte diameter	2
apoptotic characteristic	oocyte condensation	1
radical procedure	oophorectomy	3
speciality tea	oolong	2
tea bag	oolong	1
aboriginal writer	oodgeroo noonuccal	1
local gig	oop poo pah doo's	1
online classified	oodle	1
organic tea	oolong tea	1
precipitate	ooids	1
thematic program	oothukkadu venkatasubbier kritis	1
information	oolong tea weight loss	1
eukaryotic pathogen	oomycetes	2
germ cell	oogonia	2
heterologous expression system	oocytes	1
standard attraction	ooty lake	1
traditional tea	oolong tea	2
traditional tea	oolong	1
heterotrophic organism	oomycetes	1
luscious dessert	ooey gooey chocolate cinnamon rolls	1
luscious dessert	ooey-gooey chocolate cinnamon rolls	1
Popular game fish	oopu	1
chinese tea	oolong	4
chinese tea	oolong tea	3
exotic tea	oolong	2
expansion area	oostelijk havengebied	1
architectural practice	oosterhuis	1
female factor	oocyte quality	1
fish pathogen	oomycete saprolegnia parasitica	1
harbor town	oostkerke	1
incredible player	oov	1
popular tea	oolong	2
reproductive cell	oorganisms reproductive cell	1
skilled artist	oopsy daisy	1
stratigraphic feature	oolite shoal	1
vigilante group	oodua people's congress in the southwest	1
diagnostic plot	ooip	2
exclusive frame line	ooh la la de paris	1
famous liner	oocl	2
fossil group	oospores of the characeae	1
free classified site	oodle	1
radical operation	oophorectomy	1
rare & vintage item	ooak item	1
soft leather	ooze calf	1
soft leather	ooze cow	1
light tea	oolong	1
neighboring place	ooty	1
beautiful hill station	ooty	1
color guard	ooltewah h.s	1
event	oort	1
program	oovoo	3
non-skeletal component	ooids	1
software course	oop	1
undifferentiated cell	oogonium	1
badminton legend	ooi teik hock	1
colonel	oon em pyo iid	1
latency hiding technique	ooo execution	1
mobility impairment	oos	1
parasitic microorganism	oomycetes	1
picturesque hill station	ooty	2
popular scenic spot	ooty lake	1
tea variety	oolong	7
tea variety	oolong tea	1
true tea	oolong	4
true tea	oolong tea	1
visitor area	ooty	1
buffering substrate	oolite	1
digital modulation scheme	ook	1
easy guitar tab video	oompa loompa song in the guitar tabs area	1
famous hill station	ooty	1
natural and mild fertility treatment	oocyte freezing	1
outback town	oodnadatta	1
program	ooo calc	1
program	oops	1
precursor cell	oogonia	2
Primitive eukaryotes	oomycetes	1
radical intervention	oophorectomy for hormonal control	1
weight loss tea	oolong	1
weight loss tea	oolong tea	1
basic computer science concept	oo programming	1
dynamic diagram	ooa static and dynamic diagram	1
established alternative voice communication provider	ooma	1
fermented tea	oolong tea	1
healthy tea	oolong tea	1
high quality tea	oolong	1
high quality tea	oolong tea	1
large download	ooo	1
medium placement	ooh medium placement	1
nonpolarized cell	oocytes	1
paradisiacal destination	ooty	1
phytopatliogenic fungus	oomycetes	2
popular boutique brand	oohlala couture	1
primordial group	oodua peoples congress	1
small-seeded legume	oogonia of the submerged algae chara sp.	1
software development paradigm	oo	1
tea type	oolong	1
tempting product	ooh la lift	1
TIMS member	ooi ah bee	1
artificial reproductive technique	oocyte retrieval	1
basic tea	oolong tea	1
card device operation	oob tuner control	1
dark tea	oolong	3
community	ooltewah ccd	1
community	oolitic town	1
exclusive signature spa treatment	ooo la-la	1
fertility preservation technique	oocyte freezing	1
minor concomitant procedure	oophorectomy	1
nonherbal tea	oolong tea	1
object-oriented methodology	ooa by shlaer & mellor	1
object-oriented methodology	ooad by g. booch	1
powerful leaf	oolong	1
prophylactic surgery	oophorectomy	3
rare tea	oolong tea	1
REQ117 card device operation	oob tuner control	1
community	oostburg village	1
community	oologah town	1
community	ooltewah cdp	1
system development activity	ooad	1
technical pattern	oo design pattern	1
traditional chinese ingredient	oolong tea	1
vintage recipe	oozie-woozie tart	1
aboriginal-specific residential rehabilitation centre	oolong house	1
common blend	oolong	1
common Spreadsheet program	ooo calc	1
day-hike destination	ooh aah point	1
dutch encyclopedia	oosthoek	1
end-organ procedure	oophorectomy	1
organization	ooida	1
organization	ooh la la entertainment	1
organization	oosa	1
erosional surface	ootacamund	1
exotic premium tea	oolong	1
gynecologic operation	oophorectomy	1
hemibiotrophic pathogen	oomycete phytophthora	2
hemibiotrophic pathogen	oomycete phytophthora infestans	1
iconic hit	ooh la la	1
laxative side effect	oozing fecal matter	1
less-scaly animal	oodles of flamingo	1
linese	oocl	1
live cell	oocytes	1
long time favorite premium tea	oolong	1
microtubule-dependent process	oocyte specification	1
narrowband modulation scheme	ook	1
permeable aquifer	oolitic limestone	1
pre-war neighborhood	oosterparkbuurt	1
quality tea	oolong	1
resident amenity space	ool table	1
responsible toy retailer	oompa toys	2
seemingly important topic	oo programming	2
tea beverage	oolong tea beverage	1
third party defraggers	oo defrag	1
veteran ambient experimental noisemaker	oophoi	1
advanced reproductive procedure	oocyte transfer	1
Americana tapas	oozey goozey brie	1
anything radical	oopherectomy	1
asian tea	oolong tea	1
technique	oocyte vitrification	1
technique	oocyte cryopreservation	1
technique	ooplasm donation	1
technique	ooplasm transfer	1
technique	ooad	1
biotic mechanism	oophagy	1
cartoon book	oor space wullie	1
chinese tea blend	oolong	1
contemporary modularization technique	oop	2
cutting-edge video application	oovoo	1
datum access component	oo four o 	1
definite colony	oocystis	1
east kimberley community	oombulgurri	2
efficient animal	oompa-loompas	1
filamentous microorganism	oomycetes	4
filamentous pathogen	oomycetes	2
technique	ooda loop	1
good quality tea	oolong	2
good thing	ooey gooey good thing	1
hard and homogeneous rock	oolites	1
history place name	oodnadatta	1
iconic outback route	oodnadatta	1
instant tea extract	oolong tea	1
international software conference	oopsla	1
large leaf tea	oolong	1
leks	oola	1
lifestyle group	oot the hoose	1
limbless creature	ooze	1
London MPs	oona king	1
modern military concept	ooda loop	1
nike SB blazer favorite	oompa loompas	1
nonskeletal carbonate particle	ooids	1
application	oovoo	5
application	oo seven  benchmark 	1
operative laparoscopic surgery	oophorectomy	2
original short form series	oobi	1
peer-to-peer telephone service	ooma	2
popular VOIP application	oovoo	1
prescribed book	oomblik in die wind by andre p brink	1
pre-war neighbor hood	oosterparkbuurt	1
primitive fungus	oomycetes	1
pulse modulation	ook	1
regular winter bait	oolichons	1
reproduction tract lesion	oophoritis	1
reproductive and developmental tissue	oocyte	1
revered ruler	ooni of ife	1
robust tea	oolong	1
seemingly outlandish word	oolong cha	1
Slicing-side video apps	oovoo	1
small controller	oopic	3
stage cell	oogonia	1
talented local band	oohlas	1
third, new reproductive treatment option	oocyte donation	1
typical tea leaf	oolong	1
3rd party communication tool	oovoo	1
baseball inclusion	oofuri	1
broadway musical's golden age choreographer	oona white	1
Browser add-ins	oomph for internet explorer	1
name	oozoon	2
cheeper alternative	oolong tea	1
cool tsalagi name	ooh la neah tah	1
currently practically available diagnostic method	oocyst count	1
datum modulation format	ook	1
diploid and dikaryotic organism	oomycete	1
diploid pathogen	oomycetes	1
eukaryotic plant pathogen	oomycetes	2
exact criterion	oocyte diameter	1
exceptionally large cell	oocytes	1
expensive and time consuming procedure	oocyte micromanipulation	1
family solution	ooka	1
famous chinese tea	oolong	1
name	oop maximum	1
fertility preservation treatment	oocyte cryopreservation	1
first, indo-guyanese writer	oonya kempadoo	1
good old sega game	ooze	1
gram parson track	ooh las vegas	1
happy cupcake	oozing with fresh lemon juice	1
high-energy deposit	oolitic limestone	1
Hill station s	ootacamund in the western ghats	1
Hot regular tea	oolong	1
infectious ailment	oodinium	2
intercurrent drug	oophorinum	1
international software engineering conference	oopsla	1
internet-based video communication service	oovoo	2
IR-UWB modulation	ook	1
japanese pre-made tea	oolong cha	1
jdl-model and related model	ooda process	1
mindless program	oodala marri	1
mobile video-chat service	oovoo	1
model-driven methodology	oohdm	2
non-skeletal carbonate component	ooids	1
oddball business model	ooma	1
outlandish feature	oompa loompas	1
panini	oozing fontina cheese	1
parasite life cycle stage	oocysts	1
popularization videoconferencing application	oovoo	1
case	oona's prowler	1
pulsed modulation	ook	1
quality text game	ootp baseball	1
reborn molder	ooak	1
remote outback town	oodnadatta	1
Risk-reduction surgery	oophorectomy	1
robust cell	oocytes	1
Shallow-marine microfacies	ooid grainstone	1
shallow-water carbonate facies	oolitic facies	1
shop stock popular label	oobi	1
strain marker	oolites	1
sultry show	ooh la la at the paris	1
summary filamentous pathogen	oomycetes	3
Summary Filamentous pathogen s	oomycetes	1
option	oocyte donation	3
Tamil Nadu's famous hill-stations	ooty	1
today key town	oodnadatta	1
traditional modulation format	ook	1
traditional one-bit-per-symbol modulation scheme	ook	1
U.S. trucking industry interest	ooida	1
web design methodology	oohdm	1
webdesign method	oohdm	1
web's tool	oovoo	1
week's top video	ooh boy by margla	1
well-known chinese tea	oolong	1
well-priced bent pipe	oom paul rustic	1
adventurous laparoscopic procedure	oophorectomy	1
aics scholar	oosthuizen	1
option	oocyte preservation	1
baby designer	ooh la la mama	1
bandwidth efficient scheme	ook	1
baseband modulation scheme	ook	1
binomial dependent variable	oocyte recovery rate	1
blue tea	oolong	1
bottom-up and top-down rule engine	oojdrewbuandoojdrew td	1
box experience structure	oobe structure defined by microsoft	2
carbonate sediment	ooids	1
cell homogenates	oocyte homogenates	1
cheapie	ooma	2
chemically precipitated carbonate	oolites	1
classic elementary school science activity	oobleck	1
classified ad service	oodle	1
coated grain	ooids	1
common, intelligent anthropomorphic animal	oolong	2
container shipping stock	ooil	1
conventional architectural style	oo system	1
cool DNA feature	oozing dna slime bubble	1
dangerous protrusion	ooo nail	1
detrital carbonate grain	ooids	1
development person	ootp development person	1
employee-level panel datum	oosterbeek's study	1
endurantist paradigm	oo	1
entity-based model	oos	1
exciting mobile casino title	ooh aah dracula r.i.peater	1
exciting mobile title	ooh aah dracula r.i.peater	1
Extirpative surgery	oophorectomy	1
Fertility preservation	oocyte cryopreservation	3
free online handicap tracker	oob	1
full-leaf loose tea	oolong	1
gradual process disease	oos	2
grand lake	ooty lake	1
high-speed single-carrier modulation scheme	ook	1
hypermedia modeling technique	oohdm	1
Immature oocytes	oocytes at the germinal vesicle stage	1
intensity modulation scheme	ook	1
Intermediate radical species	oor ro	1
Internet speed test website	ookla's speedtest.net	1
introduction soil-borne pathogen	oomycete	1
key battle site	oosterbeek	1
large or data-intensive application	oodbms	1
mammalian germ cell	oocytes	1
mandapams	oonjal mandapam	1
materials-intensive activity	oobleck from gems	1
MCUs	oopic	1
mobile casino slot	ooh aah dracula r.i.peater	1
mobile phone casino game	ooh aah dracula r.i.peater	1
multiparous ewe	oos	1
narrow gauge modelling expression	oo nine 	1
nice hill station	ooty	1
non-replicating cell	oocytes	2
group	oorlam nama	1
group	oop's so facto	1
method	oohdm	2
ntmodulation scheme	ook	1
ooc-related material	oo design pattern	1
partial fermented green tea	oolong	1
peer-to-peer video conversation site	oovoo	1
point author	oosthuizen et al	1
Potential break-points	oolloo crossing	1
puncture procedure	oocyte collection	1
purchase slow-release system	ooze tube	1
rich, mature wood	oosterhout	1
robust paradigm	oo	1
rown Tea	oolong	1
SBA Certified Development Company	ooc	2
SBA-Certified Development Company	ooc	3
scenario modification	oob change	1
Second, amplitude modulation	ook	1
selec t cell type	oocytes	1
method	ooram	1
method	oocytle microinjection of dna	1
method	ooad support development of service component	1
Semifermented tea	oolong tea	1
semi-fermented tea	oolong	1
SOA modeling discipline	ooad	1
soaker system	ooze tubes	1
somehemibiotrophic pathogen	oomycete phytophthora	1
sometimes online game term	ooc	3
sound sculpture	oorsprong	1
suggested event	oompa-loompas on overtime obstacle course	1
tea flavored classic filling	oolong tea flavored assorted nut	1
Tea-Teas	oolong	1
thankfully natural product	oolong tea	1
user collaboration application	ooi laboratory	1
vector draw program	ooo draw	1
tool	oomph.com	1
vista class ship	oosterdam	1
Voice Over IP phone service	ooma	1
warm Chinese tea	oolong tea	1
web engineering approach	oohdm	1
west flemish coastal city	oostende	1
window CE tool	ooips two thousand  -s operating software 	1
woman labor mps	oona king	1
workflow manager	oozie	1
tool	ooda loop	1
tool	oovoo	1
factor	oof transition	1
project	oodi college of applied arts	1
project	oosterweel connection	1
project	oog in the web edition of the dutch national daily newspaper de volkskrant	1
artist	ooklah the moc	1
material	oosb board	1
place	ooty	5
place	oow	1
place	ootacumund club	1
place	ooh la la la	1
place	oodnadatta	1
player	oosthuizen	1
player	oops from catch gamer	1
technology	oo technique	2
technology	ooad	1
technology	ooh	1
product	oolong tea	2
technology	oo	1
technology	oocyte recovery	1
technology	oob management	1
term	ootw	1
system	oogenesis in mammal	1
system	ooda loop	1
species	oocystis sp	1
species	ood	1
species	ooze	1
measure	oonoonba urban development area	1
element	oorhoofse stoor	1
variable	oocyst strain	1
product	oops & goo gone	1
variable	oocyte diameter	1
device	oopic kit	1
brand	oobi	3
brand	oopa baby	1
brand	oopsy daisy baby pettiskirts	1
brand	oogies gourmet popcorn	1
concept	oop	1
component	oospore production	1
component	ooi laboratory	1
aspect	oocyte quality	1
site	oodle	7
site	oovoo	3
