initiative	pwc ned program	1
resource	pwc's training course	1
source	pwm control signal	2
source	pwm	1
game	pwi	1
subject	pws elements	1
characteristic	pw	1
word	pwnd	4
word	pwn	4
word	pwn'd	1
word	pwnt	1
client	pwc	4
document	pws	1
strategy	pwarp photon	1
alternative	pw-protected web browsable books with expirable access	1
agency	pwa	4
agency	pwsnt in alice springs	1
location	pwa	1
feature	pwll-du quarry	2
part	pwr valve	1
city	pwm to btv	1
consideration	pwer dissipated in the discharge	1
firm	pwc	7
industry	pwalugu tomato factory	1
job	pwning a n zero b 	1
test	pwht testing	1
instrument	pwi	1
feature	pwm generation	1
feature	pwned dfu	1
setting	pwm warmup	1
team	pwllheli	1
entity	pwgsc	1
entity	pwa	1
feature	pwr window	1
region	pwani	2
region	pwv	1
Organisations	pwc	1
partner	pwc	2
advanced feature	pwm	1
club	pwllheli	1
club	pwf	1
club	pw	1
design	pwr	1
store	pw supermarket	1
customer	pwc	1
department	pwd	3
feature	pwm	1
feature	pw oam	1
award	pwc trophy for accounting	1
disorder	pw syndrome	1
capability	pwm shunt battery charging	1
party	pwc	2
party	pwu	1
corporation	pwc	1
package	pwscf	1
algorithm	pwi	2
issue	pwer steering leak	1
issue	pwakkenbak creek management plan	1
supplier	pwc	1
employer	pwc	1
network	pwayboy tv	1
mode	pw doppler	1
park	pwf park	1
local organization	pwp	1
signal	pwr-ok	1
icon	pws	1
industry leader	pwc	2
local business	pw markets	1
command	pwd	9
goodie	pw window	1
item	pw	2
interface	pwm other interface	1
basic feature	pw	1
large organization	pwc	1
peripheral	pwm generator	1
international company	pwc	1
item	pwm output module	1
province	pwv	1
major	pwc	1
item	pwlb debt	1
federal agency	pwa	1
leading company	pwc	1
government department	pwd	1
assessment tool	pws	1
deal	pwc's acquisition of diamond management	1
electrical component	pwms	1
large firm	pwc	2
consultant	pwc	1
coastal region	pwllheli for homes for sale near beach	1
american company	pwc consulting	1
abbreviation	pwr for power switch	2
abbreviation	pwp	1
abbreviation	pw for power window	1
industry expert	pwc's raj mody	1
education program	pwi	1
top brand name	pws	1
critical parameter	pwm gain	1
coastal town	pwllheli	1
control method	pwm control	2
area	pwllheli	1
area	pwc grantees played at times small	1
historical building	pw vorster museum	1
renowned company	pwc	1
dialect	pwo	1
good reason	pws	1
application program	pwash one hundred and twenty-three d 	1
prestigious company	pwc	1
area	pwll road	1
adviser	pwc	1
portfolio	pwd	1
consulting firm	pwc	2
market town	pwllheli	1
unknown	pwp recharge rate	1
seaside resort	pwllheli	1
service	pws	1
global firm	pwc	1
non-invasive technique	pwv	1
web server	pws	1
complex model	pwm with spacer	3
reactor	pwr	3
local team	pwllheli	1
commercial site	pws	1
topologies	pwm converter topologies	1
electrical accessory	pwvi ballast	2
top firm	pwc	2
vascular lesion	pws	1
global client	pwc consulting	1
basic command	pwd	1
global parameter	pwm frequency	1
consultancy	pwc	1
professional service firm	pwc	3
aid organization	pwa coalition	1
backup	pw parkway	1
state department	pwd	1
modulation method	pwm	1
regional network	pwyp africa	1
market-based mechanism	pws	1
tall building	pwc headquarter	4
company	pwc	22
company	pwc design	2
company	pwc consulting	2
power option	pwr window	2
power option	pwr door lock	1
senior minister	pwd minister chhagan bhujbal	1
service request	pw information	1
auditor	pwc	2
common command	pwd	1
exploit	pwnage	1
deal program	pwa	1
company	pwc israel	1
company	pwa in europe	1
solid company	pwf	1
common file	pwsafe file	1
polymerases	pwo	5
investment banker	pwc	1
typical option	pw	1
consultancy firm	pwc	1
UNIX command	pwd	1
output signal	pwm output voltage signal	1
state government department	pwd	1
smart function	pwm-based dimming control	1
vocoders	pwi	1
basic peripheral	pwm	1
corporate program	pwc's ulysses	1
industrial feature	pwll ddu tunnel	2
roughage	pwr quality roughage	1
voltage regulator	pwm converters operated in the continuous conduction mode	1
large engine	pw wasp r four thousand three hundred and sixty 	1
relief program	pwa	1
consulting organization	pwc	1
superb product	pw zero - one hundred and four  cwna cwna from test king latest test material 	1
famous shopping mall	pwtc	1
management consulting firm	pwc	1
public work program	pwa	2
help group	pwyp canada	1
nuclear power plant	pwr plant	1
nuclear power plant	pwr	1
traditional client	pwc's other traditional client	1
event	pwc dam run	2
partial measure	pwc private business barometer	1
poe device	pwe- four thousand eight hundred and three ru poe injector 	1
fire safety feature	pwd holding point	1
large accounting firm	pwc	1
protection circuit	pwm control	1
big consulting firm	pwc	1
engine trade product	pw four thousand  	2
engine trade product	pw two thousand  	2
public firm	pwc	1
wrestling promotion	pwg	1
civic agency	pwd.	1
high-performance peripheral	pwm	1
international consulting company	pwc	1
canadian mining company	pwe	1
converter topologies	pwm converter topologies	1
custom firmware	pwnagetool	1
program	pwa	4
program	pwnage tool	3
literacy practice	pwim instruction	1
public accounting firm	pwc	1
trustworthy site	pw newswire	1
discounted cash flow technique	pw analysis	1
built-in command	pwd	1
chart parameter	pwht chart parameter	1
energy trust	pwe	1
program	pwap	1
program	pwr club	1
elite boutique	pwp	1
program	pwm	1
unix-file-system-like command	pwd	1
unix-type command	pwd	1
world top company	pwc	1
benchmarking study	pwc consulting group study	1
big accounting firm	pwc	2
common system command	pwd	1
driven circuit	pwm converter	1
full power option	pw	1
functional MR imaging technique	pwi	2
generation engine	pw two thousand  	1
jailbreak tool	pwnagetool	2
large global employer	pwc	1
local aid organization	pwa coalition in houston	1
recreational unit	pwc's	1
response team member	pwo	1
organization	pwc	2
world's brand icon	pwc	1
basic hardware element	pwm controller	1
built-in hardware feature	pwm generator	1
indy company	pwg	1
international accounting firm	pwc	1
japanese fight organization	pwfg	1
outside auditor	pwc	1
pong game	pwong  two  & war pong 	1
organization	pwa coalition	1
quality roughage	pwr quality roughage	1
referenced document	pwc comprehensive emergency management plan	1
strategy service firm	pwc	1
typically present component	pwm generator	1
virtual connection	pw using a logical communication link	2
canadian oil trust stock	pwe	1
Chinese IPOs	pwrd	1
convenient system integration function	pwm	1
technique	pwdd help	1
technique	pws	1
heat stable enzyme	pwo	1
international & national interfaith conference	pwr world convention	1
mini bike	pw  fifty  . s 	1
modern reactor design	pwr	1
application	pwm output	1
application	pwm gen-eration	1
application	pwn document scanner	1
output current modulation method	pwm	1
popular jailbreak tool	pwange tool	1
power management ICs	pwm controller	1
PWC advocate	pwia	1
shell-like command	pwd	1
spatial initial condition	pwp	1
standard file system navigation command	pwd	1
supplier & consultant	pwc	1
application	pwm dc-to-dc converter	1
typical IRIX command	pwd with the file system	1
valuable hardware resource	pwm	1
water reactor	pwr	1
apartheid murderer	pw botha	1
authority line department	pwd	1
bishopston beach	pwll du	1
Bold heroes	pwyll	1
application	pwb	1
commercial engine	pw four thousand  	1
common time field	pwdlastset	1
knowledge management effort	pwr creation	1
name	pwc	1
low-do environment	pwr environment	1
mid-sized containment design	pwr ice-condenser	1
non-traditional modulation method	pwm	1
nuclear power reactor	pwr	1
case	pwr station blackout	1
case	pwani	1
case	pwsfs sited on large wooded lot	1
power control-related peripheral	pwm	1
qshell's built-in if navigation command	pwd	1
radioactive sample	pwr primary water	1
rankine cycle nuclear plant	pwr	1
realistic operational limit	pwm modulation limit	1
reg option	pwr window	1
regional -logistic company	pwc logistics of kuwait	1
secondhand bike	pw	1
secondhand dirt bike	pw	1
SHM technique	pwas phased array technique	1
singles dance	pwp	1
switched-inductor power circuit	pwm motor drive	2
time critical module	pwm	1
typical control function	pwm motor control	1
unlock tool	pwnagetool	2
water sport use	pwc riding	1
advanced functional imaging technique	pwi demonstrating an rcbv map	1
advanced jailbreak method	pwnagetool andsn zero wbreeze 	1
apartheid president	pw botha	1
Archaeal proof-reading polymerases	pwo from pyrococcus woesei	2
astounding application	pwnboxer multiboxing software	1
AVR8 feature	pwm	1
basic user module	pwm	1
component board	pwb	1
option	pw	1
group	pwo karen	2
group	pwg	2
external digital clock signal	pwm output of a microcontroller	1
family place	pwllheli	1
fault description	pwa faulty	1
fixed frequency application	pwm rectifier	1
independent wrestling show	pwp	1
indys	pwg	1
group	pwo	1
group	pwm	1
group	pwa	1
group	pwp	1
largest SA company	pwc	1
left-wing extremist outfit	pwg	1
loft club	pw	1
logic-level input	pwm generated at a microprocessor output pin	1
low-oil-level environment	pws	1
master PWM controller	pwm controller  two hundred and twenty a of fig 	1
power control method	pwm	1
prevailing vessel-type light water reactor	pwr s	1
pulse modulation amplifier	pwm amplifier	2
pwc international member firm	pwc bermuda	1
PWM generator	pwm generator  two hundred and eight a 	1
realistic 3D shape	pwb	1
second generation reactor	pwr	1
method	pwas lamb wave method	1
shallow target	pws	1
so-called biophotonics technology tool	pws	2
structural reason functional parameter	pwv	1
suitable picture host	pwimage.org  one  invalid image found 	1
supported lovely, decent humanitarian leader	pw botha	1
top professional service company	pwc	1
untethered jailbreak tool	pwnage tool	1
tool	pwdump	3
voltage acquisition	pwm currents at the output of the inverter	1
voltage source inverter	pwm inverter	2
water vapor observation	pwv retrieved from gps observation	1
word's	pwn	1
tool	pwnage tool  four . one . three  unlock edition 	1
tool	pwnage	1
tool	pwh	1
tool	pwb art master	1
artist	pw two  mime ministry 	1
material	pwm ic	1
player	pwc	1
technology	pwrb heating mantle	1
parameter	pwnlvl	1
parameter	pwd passed in the code	1
parameter	pwht chart parameter	1
parameter	pwclvl	1
parameter	pwv	1
system	pwr two  nuclear reactor 	1
measure	pwv	1
element	pwb	1
element	pwv	1
product	pwm regulator ic	1
variable	pwb surface finish	1
function	pwm output	2
function	pwm	1
device	pwm hydraulic valve	1
brand	pwl	1
site	pwhelli marina	1
