exception	pz six  at betton 	1
category	pzl	1
client	pz cussons	2
product	pzt related product	1
approach	pzt	1
writer	pz myers	1
action	pz's desecration'' of a communion wafer	1
firm	pzena investment management co.	1
individual	pz myers	1
region	pzt thin film layer	1
design	pzam silent cartridge	1
customer	pz cussons	1
issue	pzt sensing region	1
scientist	pz	1
scientist	pz myers	1
domain	pzs	1
apps	pzizz sleep	1
item	pzt	1
multinational company	pz	1
metal oxide	pzt	1
actuator	pzt	1
ceramic	pzt	1
ceramic material	pzt ceramic	1
professional company	pzu group	1
transducer	pzt transducer	1
atheist	pz myers	2
atheist	pz meyers	1
Nanoparticles	pzt	3
clothing line	pzi jean	1
active material	pzt	1
domestic player	pzu	1
piezoelectric material	pzt	22
piezoelectric material	pzt- five a 	1
piezoelectric material	pzt- seven a 	1
piezoelectric material	pzt- five h 	1
piezoelectric material	pzt- eight 	1
dielectric	pzt	1
trading company	pz	1
product manufacturer	pz	1
company	pz cussons	3
ferroelectric material	pzt	15
company	pz	1
smart material	pzt	3
company	pzi jeans	1
multinational enterprise	pz cussions	1
standard design	pzjg i	1
example material	pzt- five h ceramic 	1
metal oxide film	pzt film	1
freethinker	pz myers	1
heavy	pzkpfw vi tiger	2
ceramic filler	pzt	1
perovskite material	pzt described	1
perovskite material	pzt	1
piezoelectric element	pzt disk	1
piezoelectric element	pzt	1
piezoelectric element	pzt element	1
first-line drug	pza	1
humane method	pzp	1
material class	pzt	1
ferroelectric ceramic	pzt	3
electromechanical transducer	pzt	2
news atheists	pz myers	1
information	pz security plan	1
piezoelectric ceramic	pzt	3
contraception	pzp	1
famous atheist	pz myers	1
high-k dielectric	pzt with a fine control of the nanostructure	1
ferroelectric film	pzt	7
ferroelectric film	pzt film	2
ferroelectrics	pzt bst	1
heavy-weights	pz meyers	1
piezoelectric crystal	pzt	2
titanates	pzt	3
perovskite oxide	pzt	2
piezo-electric material	pzt	1
ferroelectric thin film	pzt	1
production plant	pzl mielec	1
production plant	pzl swidnik	1
production plant	pzl warszawa	1
solid solution	pzt	1
binary and ternary oxide	pzt	1
electroceramics	pzt	4
piezoelectric ceramic material	pzt ceramic material	1
piezoelectric film	pzt	1
polish financial institution	pzu asset management	1
Ferroelectric perovskites	pzt	2
ferroelectric substance	pzt	2
gap model	pzb gaps model	1
plenty more type	pzm	1
third drug	pza	1
Atheist bloggers	pz	1
dielectric oxide	pzt	1
dutch pottery	pzh	1
ferroelectric oxide ceramic	pzt	6
Perovskite ferroelectrics	pzt	1
pyroelectric element	pzt	1
reputable multinational customer	pz cussons	1
Thenanoparticles	pzt	1
well-known ferroelectrics	pzt	1
Advanced amines	pz	2
conventional ferroelectric material	pzt	1
conventional noise term	pzt miscalibration	2
embedded perovskite capacitance material	pzt	2
ferroelectrics film	pzt	1
fracture mechanic ceramic material	pzt	1
high-dielectric-constant filler	pzt	1
large FMCG account	pz cussons	1
light german tank	pzkpfw i	1
long-term reliable partner	pzu ukraine	1
multi-component oxide film	pzt	1
opaque piezo material	pzt	1
perovskite metal oxide	pzt	1
photo-voltaic ferroelectric ceramic material	pzt	1
Polish aircraft	pzl  twenty-three  karas 	1
Polish aircraft	pzl p- eleven 	1
strong atheist	pz myers	1
tank unit	pzkpf ii	1
tetragonal ferroelectrics	pzt	1
today's atheist	pz myers	1
ultrasonic transducer element	pzt piezoelectric crystal	1
active transducer	pzt	1
advanced helicopter	pzl sw- four 	1
atheist site	pz myers	1
boundary mic	pzm	1
ceramic actuator	pzt	1
ceramic piezoelectric element	pzt	3
ceramicpiezoelectric element	pzt	1
common ferroelectric material	pzt	1
complex piezoelectric material	pzt	1
excellent ferroelectric thin film	pzt thin film	1
extremely im-portantfor complex oxide	pzt	1
Fertility control	pzp	1
high resolution motion system	pzt system	1
induced strain actuator	pzt	1
INTRODUCTION ferroelectric compound	pzt	1
lead-base perovskite compound	pzt	1
lead-containing abo.sub.3-type ferroelectric oxide	pzt	2
lead-containing abo3-type ferroelectric oxide	pzt	1
Light panzers	pzkpfw ii	1
mid-war vehicle	pz iiis	1
militant desecrationist atheist	pz myers	1
monolithic brittle structure	pzt wafer	1
normally-used piezoelectric ceramic	pzt	1
outspoken atheist scientist	pz myers	1
piezoceramics	pzt	1
piezoelectric crystalline material	pzt	1
piezo-electric element	pzt	1
polycrystaline ceramic	pzt	1
popular piezoelectric material	pzt	3
premier side	pz	1
PZT device	pzt switch	1
Single-crystal perovskites	pzt	1
soft ceramic	pzt  five hand five a 	1
spectacular kit	pzkpfw iii	1
state-of-the-art piezoelectric material	pzt ceramic	1
sub-model INTRODUCTION piezoelectric element	pzt	1
suitable piezoelectric material	pzt	1
transducer material	pzt ceramic	1
typical piezoelectric material	pzt	1
unabashed atheist	pz myers	1
material	pzt	8
material	pzt paste	2
material	pzlt precursor	1
material	pzt s	1
place	pzza delivery place	1
device	pzt module	2
related product	pzt related product	1
