product	qemm	1
work	qeshm island	1
work	qesse-ye bagh-e maryam by morteza rezvan	1
attraction	qe two 	1
attraction	qeh theatre	1
skill	qei training	1
idea	qed	1
action	qe three  from central banker 	1
development	qe	1
city	qena	1
venue	qeii conference center	1
favorite	qeii activity centre	1
manufacturer	qed	1
mean	qeii	1
policy	qe two 	2
policy	qe three 	1
policy	qe one 	1
policy	qeii	1
Organisations	qeii trust	1
vendor	qed	2
scheme	qe one 	2
magazine	qex	1
addition	qe two  sprint triathlon in the north east 	2
theory	qed	2
guy	qemists	1
park	qeii park	1
quantity	qe	2
hospital	qeii	1
ethnic group	qezelbashs	3
imaging technique	qeeg datum	1
funding source	qeia grant	1
private company	qena-aswan railway company	1
ship	qe two 	3
ship	qe ii	1
product line	qee	2
big brand	qeyi	1
government program	qe two 	1
comment	qejxkm watch movies online ptciygp every single day	1
big city	qeynos in everquest  two 	1
community facility	qeii	1
cable	qed	1
cable	qed silver aniversay	1
popular name	qee	1
popular feature	qep	1
area	qeynos hills	1
credit	qeze tax reduction credit	1
emulator	qemu	6
emulator	qemux	1
third-party product	qemm	1
narrative	qe	1
liner	qe two 	2
offshore island	qeshm	1
popular line	qee	1
mainstream brand	qed	1
cruise ship	qe two 	6
large ship	qe two 	2
virtual machine	qemu	5
botanist	qeorge caley	1
rotation	qec block	1
covenant	qeii covenants administered by the qeii trust	1
company	qei	1
cruise liner	qe two 	2
modern theory	qed	1
singapore company	qed systems	1
famous theater	qeh	1
theoretical idea	qed	1
information	qemu-kvm command line	1
outrage	qes outrage over the ub house	1
outrage	qes outrage over the ellicott house	1
litigation issue	qest pipe	1
memory manager	qemm	10
memory manager	qemm on the server being installed	1
university initiative	qep	1
discretionary action	qe two 	1
government fund	qef	1
luxury cruise ship	qe two 	1
ocean liner	qeii	1
respected manufacturer	qed	1
classic parameter	qe	1
trade centre	qendra tregtare univers	1
internationally renowned sport title holder	qenenisa beqele	2
civilian ship	qe two 	1
RDF query language	qel	1
program	qemm	1
managed-care program	qexa program	1
policy announcement	qe three 	1
prestigious british venue	qeh	1
quantum field theory	qed	2
complementary geo-analytical technique	qemscan	1
Economic 280events	qe two 	1
luxury ship	qe two  with mainstream ships like the fantasy 	1
ageing facility	qems	1
college wide committee	qep committee for sacs	1
complicated theory	qed	1
daily quality staff function	qe	1
technique	qemscan	1
intermediary, intellectual property company	qed intellectual property	1
large comprehensive school	qeh	1
MCC committee	qep committee	1
tempting touse virtual machine	qemu	1
third party memory manager	qemm	3
application	qeep	1
consolidating federal and state fund	qeia fund	1
em memory manager	qemm	1
extended memory manager	qemm	1
good neutral cable	qed silver anniversary	1
interacting relativistic quantum field theory	qed	1
factor	qentr  three 	1
factor	qentr  four 	1
memory manager program	qemm	2
north arabian city	qedar	2
private Trust	qe ii national trust	1
abelian gauge theory	qed	1
advanced mineralogical tool	qemscan	1
automated scanning electron microscope	qemscan	1
basic speaker cable	qed original	1
borne memory manager	qemm- three hundred and eighty-six 	1
brand agency partner	qed creative	1
branded cable	qed	1
commercial memory manager	qemm	1
do memory manager	qemm	1
earliest northern mesopotamian settlement	qermez dere	1
emulation system	qemu	1
fed's massive currency printing scheme	qei	1
final operational approval	qer	1
flat diode	qed diode	1
free desktop quiz creator	qedoc quiz maker	1
free quiz tool	qedoc quiz maker	1
full instruction set emulator	qemu	1
good quality HDMI cable	qed qunex	1
Grandfather ships	qeii	1
inexpensive third-party program	qemm from quarterdeck	1
group	qetzal string quartet	1
group	qeii a queen tribute band	1
ing locality	qellwara in lapland	1
inner-city work destination	qeii	1
international cruise ship	qe- two 	1
quantitative easing measure	qe three 	1
rinse-less wash	qew	1
state machine implementation technique	qep	1
third party memory management program	qemm	1
traditional quantum field theory	qed	1
typical super-sized ocean liner	qe two 	1
tool	qec	2
Voodoo economics	qe	4
withfleld theory	qed	1
factor	qentr  one 	1
project	qemu than buy vmware	1
artist	qemists	2
technology	qemscan	1
technology	qemu	1
term	qemes	1
system	qemu	1
measure	qe	1
product	qea's personal ias	1
variable	qeia schools	1
function	qenable utility	1
brand	qed	2
brand	qep	2
