process	qttask	1
model	qtrap  four thousand  	1
situation	qt monitoring in drug trial	1
situation	qt interval measurement	1
document	qts certificate	1
approach	qtl analysis	1
alternative	qt	2
alternative	qt lite for windows	1
circumstance	qtip trust	1
type	qtz five thousand and thirteen 	2
type	qtz  seven thousand and thirty 	2
type	qtz five thousand five hundred and twenty 	2
type	qtz six thousand and fifteen 	2
type	qtz five thousand five hundred and thirteen 	2
type	qtz six thousand five hundred and sixteen 	2
type	qtz six thousand and twelve 	2
type	qt	1
drug	qt syndrome many drug	1
drug	qt prolonging antiarrhythmic medication	1
complication	qt prolongation	2
feature	qt falcon	1
feature	qt port	1
medication	qt-prolonging medicine	1
format	qt	4
standard	qti	2
standard	qti  one . two 	1
side effect	qt interval prolongation	2
side effect	qt preview atifacts	1
software	qt lite	1
software	qt vr authoring studio	1
module	qt mobility	1
module	qt components	1
party	qtopia's bluetooth settings application	1
issue	qtc	2
possibility	qt gui editor	1
language	qtscript	2
supplier	qtek	1
operator	qtel	2
station	qt at north druid hills	1
forum	qt interest mailing list	1
signal	qth	1
carrier	qtel qatar	1
advanced topic	qtip trust	1
injury	qtip	1
goodie	qt quick	1
key player	qtel	1
qualification	qts	1
adverse effect	qtc prolongation	1
framework	qt	2
framework	qtkit	1
library	qt	2
library	qt library	1
entry	qttask	1
confounding factor	qt-prolonging drug	1
ship	qtr powered by solar power	1
small object	qtip	1
key parameter	qtch  one hundred and eighty-eight 	1
key parameter	qt interval  one hundred and eighty-six 	1
innovative technology	qtl analysis	2
clinical feature	qt morphologic characteristic	1
item	qttask	1
web application	qtt	1
heavy hitter	qtel group	1
plugins	qtip	1
continuous variable	qt value	1
popular application	qt creator	1
trust	qtip trust	2
video format	qt	3
dependency	qt quick	1
online company	qtoner available for quick replacement toner order	1
third-party tool	qt jambi	1
serious adverse effect	qtc interval prolongation	1
service	qtrax	1
popular format	qt	1
licensee	qtel	1
toolkits	qt	5
document format	qt	1
end	qt	1
molecular approach	qtl mapping	1
mobile operator	qtel	1
popular video format	qt	100
up-to-date information	qtac update	1
topic	qtac application	1
topic	qtl	1
topic	qtl identification	1
non-invasive test	qt dispersion	1
government authority	qts	1
automation tool	qtp	2
IDEs	qt	2
IDEs	qt creator	1
software maker	qt cross-platform development framework provider trolltech	1
genetic approach	qtl analysis	1
specialty system	qtronix electronics	2
ECG change	qt c prolongation	1
ECG change	qtc interval prolongation	1
company	qtel	1
comedy program	qtv's ay	2
comedy program	qtv s ay	2
proven program	qtv	1
technology standard	qti	1
regional operator	qtel	1
video file format	qt	1
featuring speaker	qt's own alexis menard	1
sale information	qty	1
time interval	qt interval	1
severe adverse reaction	qt prolongation	1
ECG abnormality	qt prolongation	2
company	qtera	1
cardiac abnormality	qt prolongation	1
genetic method	qtl analysis	1
tax form	qtrly payroll report	1
popular video file	qt	1
complic ations	qt prolongation	1
open-source technology	qt	1
external library	qt	1
bolt-ons	qtp long tube header	1
cardiac effect	qt-interval prolongation	7
testing solution	qtp	1
advanced analysis	qtl mapping	1
datas	qty	1
partition manager	qtparted from linux	1
information	qt interval time	1
ECG parameter	qt interval	4
ECG parameter	qt apex	1
pocket PC phone	qtek  eight thousand five hundred 	1
popular video format s	qt	8
transient ECG change	qt prolongation in a pattern suggestive of right ventricular strain	1
genetic analysis	qtl mapping	2
molecular study	qtl analysis	1
information	qt screening checklist information	1
featuring accessory	qt- eleven  guitar tuner 	1
GUI library	qt	1
ofpopular video format	qt	1
cross-platform library	qt	1
event	qtc prolongation	1
event system	qt signal	1
electrocardiographic parameter	qt apex	1
GUI framework	qt	1
program	qttask	1
cross platform library	qt	3
GUI toolkits	qt	2
powerful genetic tool	qtl mapping	1
QA tool	qtp	1
GUI system	qt four 	1
program	qts advisory board	1
program	qtphase  twenty  in the case of haplotypes 	1
open source toolkits	qt	2
popular islamic channel	qtv	1
caption format	qt text	7
cardiac side effect	qt-interval prolongation	1
established and promising technique	qtl mapping with pedigreed population	1
serious cardiac adverse effect	qt prolongation	2
serious cardiac adverse effect	qt pro- longationand torsade de pointes	1
state-of-the-art genomics technique	qtl	1
360-degree graphic	qtvr	1
client world-leading organization	qtel	1
genetic mapping approach	qtl mapping	2
GUI frontends	qt	1
repolarization abnormality	qt prolongation	1
window toolkits	qt	1
Anna's plug-ins	qt adconnector	1
cardiotoxic effect	qt prolongation	1
cardiotoxic effect	qtc interval prolongation	1
cross-platform framework	qt	1
dependent package	qt	1
electrocardiogram waveform element	qt interval	1
electrophysiological abnormality	qtc prolongation	1
endless class library	qt	1
excellent library	qt	1
free software library	qt	1
technique	qtl mapping	1
gas control device	qtvc volume controller	2
level project	qt framework	1
portable GUI toolkits	qt	1
powerful statistical method	qtl mapping analysis	1
quick dry top coat	qticas quick dry drops	2
application	qt linguist	1
application	qtl mapping	1
application	qt version of the mozilla browser	1
big commercial operator	qts	3
big distribution network	qta	1
canonical's recent ubuntu change	qt integration	1
capture playback tool	qtp	3
cart table column heading	qty	1
correct spec	qts	1
cross platform framework	qt	1
cross-platform application framework	qt	1
cross-platform or non-windows GUI framework	qt	1
cross-platform toolkits	qt	2
cutting-edge internet technology	qtvr	1
discrete global grid	qtm	1
graphical port	qt versions of nethack	1
HP testing tool	qtp	1
intuitive yet powerful tool	qt designer	1
metal halide lamp	qt lamps in the form of low-voltage halogen incandescent lamp	1
Music production apps	qtractor	1
powerful, intuitive tool	qt designer	1
quality certification program	qts scheme	1
read-only file system	qtree in a snapmirror relationship	1
read-only fle system	qtree in a snapmirror relationship	1
repolarisation disturbance	qt interval prolongation	1
Routine electrocardiographic parameteres	qt interval	1
serious ad-verse effect	qtc interval prolongation	1
severe cardiac adverse effect	qt interval prolongation	1
so-called off-target effect	qt interval prolongation	1
standard GUI toolkits	qt	1
standard hierarchical grid	qtm	1
theoretically useful marker	qt dispersion	1
thioridazine serious cardiovascular adverse reaction	qt prolongation	1
time intellignece calculation	qtd	1
city satellite broadcaster	qtv in qingdao	1
classical and molecular genetic method	qtl analysis	2
common automation tool	qtp	1
cross platform option	qt four 	1
cross platform toolkits	qt	1
cross-platform GUI library	qt	1
cross-platform programming framework	qt	1
desktop GUI builder tool	qt designer	1
option	qty discounts available	1
ECG interval	qt interval	1
ECG marker	qt dispersion	1
electronic queuing system	qtraccf from lavi industries	1
forward genetic technique	qtl mapping	1
generic rom	qtek	1
genome-wide gene-searching method	qtl analysis	1
GUItoolkits	qtand motif	1
high accuracy instrument	qtof	1
high-level APIs	qt	1
level package	qt	1
marker-based mapping approach	qtl mapping	1
monetarism	qtm	1
native toolkits	qt	2
method	qtc method	1
normal framework	qt four 	1
preliminary round many source	qti survey result	1
Q-codes	qth for location	1
QTL program	qtl cartographer	1
QTLprograms	qtl cartographer	1
quail cell line	qt thirty-five  cell line 	1
quantitative genetic research technique	qtl mapping	1
method	qtl mapping method	1
shelve solution	qtp	1
single application solution	qt desktop application	1
speciaj situation	qt monitoring in drug trial	1
standard qt editing tool	qt designer for form file	3
standard QTL software package	qtl cartographer	1
table class	qtable from the qt application framework	3
Third-party librairies	qt four  on linux 	1
totally barren system	qt tank	1
triple quadruple mass spectrometer	qtrap  four thousand  	1
tool	qtp	9
wahabi TV channel	qtv	1
tool	qtip trusts	1
tool	qtc view acoustic signals from single-beam echosounder	1
tool	qtl mapping	1
tool	qt four 	1
tool	qt development kit	1
material	qt plate	1
player	qtel	1
technology	qt	2
technology	qtvr	1
term	qtip trusts	1
parameter	qtc	2
parameter	qt interval	1
measure	qty ordered	1
product	qt vw aux two  wire assembly 	1
function	qt  four . six . three 	1
function	qtget return a bool indicating the state of the object	1
device	qtek  nine thousand one hundred 	1
