product	s'mores bar	1
attraction	s'albufera wetlands nature park	1
idea	s'mores with fine dining flair	1
favorite	s'wonderful	1
attribute	s'infinity	1
attribute	s'finite	1
variety	s'mores caramel pecan	1
recipe	s'more pies	1
snack	s'mores	1
historical site	s'illot son vaquer	1
sweet	s'mores ice cream cake	1
area	s'arenal district of palma	2
national holiday	s'mores day	1
signature drink	s'mores cocktail	1
great beach	s'agaro	1
activity	s'mores at the fire pit	1
teen program	s'mores galore beach fire	1
asian metropolis	s'pore	1
enemy attack	s'crow bell	1
enemy attack	s'crow funk	1
regional tribe	s'klallam	1
craving yummy food-like scent	s'mores	1
delicious camp food	s'more bars	1
quaint coast town	s'agaro	1
after-dinner treat	s'mores made in advance in the microwave	1
name	s'forths	1
fun cupcake	s'mores cupcake	1
local first person tribe	s'klallam	1
basic and simple dish	s's half-lobster salad starter	1
FD	s'pore	1
