product	t's	1
product	t'ai chi chih on the rocks	1
character	t's great-uncle ben	1
work	t'ien	2
form	t'ai chi	2
part	t's	1
practice	t'ai chi	6
class	t'ai chi	4
class	t'ai chi chih	1
figure	t'aego pou built upon chinul's work	2
style	t'rinn's use of gray	1
exercise	t'ai chi	3
exercise	t'ai chi ch uan	1
discipline	t'ai chi	4
discipline	t'ai-chi ch'uan	1
discipline	t'ai chi chu'an	1
therapy	t'ai chi	2
poet	t'ao yuan-ming	1
hit	t'is time featuring menjoe	2
tribe	t'boli	2
art	t'ai chi ch uan	1
art	t'ai chi chuan	1
social activity	t'ai chi	1
fitting	t's	1
item	t's for extended time	1
relaxation technique	t'ai chi	1
martial art	t'ai chi ch uan	5
martial art	t'ai-chi ch'uan	1
martial art	t'ai qi	1
traditional instrument	t'rung	2
practical activity	t'ai chi	1
dynasty	t'ang dynasty	1
light exercise	t'ai chi	1
indigenous peoples	t'boli	1
vigorous activity	t'ai chi	1
emperor	t'ai-tsung	1
fitness program	t'ai chi	1
gentle exercise	t'ai chi	1
holistic practice	t'ai chi	1
activity	t'ai chi chuan routine	4
activity	t'ai chi	3
chinese martial art	t'ai chi ch uan	1
calming exercise	t'ai chi	1
meditative exercise	t'ai chi	1
martial art discipline	t'ai chi ch uan	1
movement exercise	t'ai chi ch uan	2
movement system	t'ai chi breath series	1
impersonal force	t'ien of confucianism	1
program	t'ai chi	2
program	t's for trees	1
somatic discipline	t'ai chi	1
Vulcans	t'pol	8
low-level exercise program	t'ai chi	3
classical body development technique	t'ai chi ch uan	1
energy-building practice	t'ai chi	1
low level exercise program	t'ai chi	2
non-western technique	t'ai chi	1
outstanding integrative medicine educational program	t'ai chi	1
technique	t'ai chi	1
classical psychospiritual discipline	t'ai chi	1
time many form	t'ai chi	1
adequate low-level exercise program	t'ai chi	1
name	t'pau	1
forerunner-like race	t'kon empire	1
large size malleable fitting	t's	1
questionable deal	t'wolves giving darko	1
real discipline	t'ai chi	1
aerobic and softer practice	t'ai chi	1
bland character	t'pol	1
chinese term	t'ai chi	1
Islamic music	t'ala al badru alyna by mesut kurtis	1
renowned faculty member	t'ang quartet	1
ribes	t'boli	1
traditional chinese wedding	t'ang dynasty hanfu	1
tool	t'ai chi	1
element	t'ai chi form	1
