initiative	uo mobile	1
datum	uom conversion	1
process	uop's platforming process	1
game	uo	11
product	uoe pipe	1
institution	uofa	1
institution	uom	1
client	uob	1
agency	uob travel planners	1
school	uofm	1
website	uopsucks.com	1
team	uog men's ultimate club team	1
influence	uo s classless	1
scheme	uow cares	1
award	uofa outstanding research assistant award	1
report	uoc occurrence reports	1
university	uow	1
bank	uob	7
station	uofc	1
large company	uol	1
fund	uob gold	1
competition	uow band competition	1
factor	uorf length	2
college	uofm	1
annual event	uofo's soccer tournament	1
attachment	uoled color monitor	1
developer	uol group	1
hospital	uofa	1
financial institution	uob	1
local event	uofo basketball games	1
catalyst	uop's dhc- two 	2
imaging technique	uot	1
complex issue	uom option	1
composition	uo three 	1
well-known company	uop	2
institute	uoh	1
analytical technique	uorescence spectroscopy	1
neighbor	uo junior from los angeles	1
venture	uomo moda	1
ion	uo	1
dye	uorescent nucleic acid dye	1
portal	uol	2
molecular technique	uorescence in situ hybridization	1
holding	uob group	1
research institution	uo	1
famous company	uop	1
private university	uop in stockton	1
share	uob	1
student club	uoft dance club	1
business school	uoft	1
service	uofc capital equipment project	1
local bank	uob	2
brokerage	uob - kay hian	1
static datum	uom	1
event service	uo football	1
online school	uop	1
financier	uob bank	1
traditionalist	uo senior tight end david paulson	1
MMOs	uo	1
company	uop	4
expensive program	uofl	1
great university	uofi	1
company	uop llc of the u.s.	1
company	uop based in illinois	1
company	uob	1
starting material	uo two  prepared by sintering 	1
leading financial institution	uob thailand bank	1
tourism area	uong bi	1
crystalline phase	uo two 	1
solid acid catalyst	uop's detal catalyst	1
on-line game	uo	1
insoluble salt	uo two 	1
complex parameter	uorescence emission spectrum	1
positive ion	uo two 	1
information	uom conversion	2
information	uof report	1
developmental tool	uofiddler	1
coal-fired power plant	uong bi	1
adsorption process	uop's sorbex process	5
DVD copy protection	uops	3
copy protection	uops	1
event	uob painting of the year	1
event	uow dj comp	1
low dielectric material	uorinatedsilicon oxide	1
low dielectric material	uoropolymerimd layer	1
stock company	uob	1
strong anti-aromatase compound	uops	1
hard word	uo man	1
property player	uol	1
D1 school	uofi chicago	1
singapore bank	uob	3
organization	uob group	2
organization	uob	1
bypass different protection	uops	1
common protection method	uops	1
organization	uol	1
nucleic acid dye	uorescent nucleic acid dye	1
uranyl compound	uo twenty-two 	1
technique	uorescence resonance energy transfer	1
baud digital satellite	uo- twenty-two 	1
conversion mod	uomo universalis	1
technique	uorescence recovery afterphotobleaching	1
private pharmacy school	uop	1
singapore's local bank	uob	3
uranium oxide	uo two 	2
uranium oxide	uo three 	1
name	uob	1
contact university	uoft	1
case	uorescent lamp	1
phat property major	uol group	1
uranium product	uo two  powder 	1
encrypted or copy-protected DVDs	uops	5
fantasy medieval rpg style mmos	uo	1
grantee area	uospa the nutrition	1
high density catalyst	uop's r- fifty-six 	1
Non-irradiated material	uoc	1
online educator	uoc	1
open-pvp game	uo	1
optical imaging -diagnostic	uorescence imaging	1
screen shot capture program	uo screen shot utility	1
selective amine process	uop ucarsol process	1
singapore-listed property developer	uol group	1
solid and semi-metallic compound	uo	16
specialty tray design	uop md tray	1
test mission	uosat- twelve 	1
UK university system	uol	1
updated system	uop catalyst regeneration control system	1
water resource caution area	uor	1
player	uob	1
brand	uob	1
