alternative	wvo	1
agency	wv department of environmental protection	1
structure	wvr datum	1
school	wvu	3
figure	wvr pr kokuho	1
team	wvu	1
feature	wvga resolution display	1
feature	wvga touch screen display	1
magazine	wv executive	2
district	wv- one 	1
district	wv- two 	1
state	wv	1
key item	wva dept of motor veh economic	1
quality ringtones	wv fight song ringtone	1
local organization	wvu extension service	1
college	wvu	2
college	wvsc	1
prop	wv brook trout brochure	1
oil	wvo	1
county	wv coal country county	1
local business	wvu institute of technology	1
candidate	wvdial	1
non-profit organization	wv rivers coalition	1
meeting	wva-vvrs meeting	1
community activity	wviz	1
avenue	wvu athletics	1
traditional technique	wvr	1
radio station	wvks	2
radio station	wvch	2
radio station	wvlk	1
radio station	wvoc	1
radio station	wvon-am	1
item	wv honey	1
holiday	wv day	1
advocate	wvsma's barbara good	1
item	wv property tax	1
datum set	wvs	1
liberal	wvon alumnus roland martin	1
grant	wv reads	2
asbestos company	wv malleable iron in point pleasant	1
high-end feature	wvga amoled screen	1
video format	wvx	2
basic property	wvtr	1
large facility	wvu	1
international project	wvs	1
law school	wvu & georgetown	1
television station	wvua in tuscaloosa	1
local team	wvu near locks for the tourny	1
big game	wva	1
conversion	wvm to dvd	1
independent school	wvu	1
public employer	wvu	1
training module	wvit	1
reputable vendor	wvu bookstore	1
optional unit	wv-cu three hundred and sixty  system controller 	1
local channel	wvec-tv	1
library system	wvls	1
on-line source	wvma	1
alumnus group	wvu alumni association chapter	1
housing organization	wv office of hud	1
housing organization	wv affordable housing trust fund	1
land-grant university	wvu	1
barrier property	wvtr	1
wireless network application	wvoip system	1
awesome name	wvu . biz	1
country office	wv rwanda	1
event	wvc	1
magnetic card	wvu id card	1
music competition	wvu young artists competition	1
volume indicator	wvr	1
event	wvu chorus	1
program	wvdial	4
program	wv breast	2
program	wvthatreshape matrix	1
adult alternative station	wvrv st.louis	1
ESAs	wvt	1
program	wvs	1
radio interview	wvox	1
west virginia	wv	0
nonprofi t organization	wv free	1
unapproved fuel	wvo	1
area radio station	wvmt	1
messaging capability	wvim	1
third, recent initiative	wv courtesy patrol	1
comparative technique	wva	2
cross-national survey	wvs	1
organization	wv women's commission	1
organization	wvkr radio	1
organization	wv highlands conservancy	1
organization	wva	1
Good cross-series information	wva.	2
file conversion utility	wvhtml	2
great offense	wvu	1
mathematical logician	wv quine	1
northern ugandan actor	wvu	1
f-16's role	wvr	1
scholarship pageant	wv freedom festival	1
servo-operated cooling water regulator	wvts	1
servo-operated cooling water regulator	wvs	1
simple file name	wv twenty  in the default folder 	1
technical assistance need	wvbccsp policy	1
astute private medical organization	wvp health authority	1
option	wvu	1
group	wvhtc foundation	2
forum commuter campus	wvsu	1
group	wvu habitat for humanity	1
interesting raffle prize	wv craft	1
LCD material	wv film	1
long-running jock	wvee-fm's magic man	1
news bulletin	wvu hospital receiving primary stroke center certification in march	2
qualified non-profit conservation organization	wvlt	1
rez fix	wvga fix	1
thick fuel	wvo	1
three-dimensional function	wv signal of vibration accelerations in a gear with local damage	1
top big east school	wvu	1
well-accomplished radio station	wvfs in the communications realm	1
place	wvu	1
device	wvt device	1
