product	xd card reader related product	1
product	xd card related product	1
product	xda atom pure related product	1
product	xdxl  ten thousand and eleven  wood crafts 	1
datum	xds	1
product	xdsl system	1
product	xdsl modem related product	1
product	xda pda related product	1
product	xda phone related product	1
feature	xdoclet integration	9
solution	xds biodiesel analyser from foss	1
solution	xda ii	1
band	xdisciplex ad	1
feature	xds instrument standardisation	1
feature	xds dual sequencer	1
type	xd card	1
website	xdrive	1
website	xda developer	1
format	xdcam hd	5
format	xd	2
format	xdcam	1
format	xd card	1
format	xdf	1
vendor	xdrive	1
module	xdebug module	1
language	xduce	2
algorithm	xdelta	1
car	xd falcon	1
protocol	xdr	2
protocol	xds	1
card	xd	2
apps	xda	1
page	xda	1
threat	xdos attack	1
developer	xda forum member subpsyke	2
tenant	xdrive	1
gadget	xda ii	1
online service	xdrive	4
construct	xdr union	1
camera	xdcam coming down a little	1
phone	xda ii	1
connection	xdsl	1
minor change	xdcam	1
item	xda shutdown	1
external device	xdsl modem	1
gun	xd	2
file format	xdcam	1
font	xdvng.ttf for devanagari	1
consumer electronics	xd-picture card	1
free tool	xdoclet	1
programming language	xduce	1
hardware device	xda ii	1
network device	xdsl-cable modem	1
network device	xdsl  seven  modem 	1
chip	xdr dram	1
functional element	xdsl assembly	1
network element	xdsl implementation	2
small accessory	xd-picture card	1
service	xdrive	2
service	xdrive.com	2
ETFs	xdv	1
memory card	xd card	3
memory card	xd-picture card	3
memory card	xd	3
amplifier	xd amplifier	1
service	xds	1
access technology	xdsl	1
access technology	xdsl emerging	1
pistol	xd	2
toolkits	xdialog	1
good product	xdcam range of hd cam	1
good company	xdrive	1
common technology	xdr for compact portable data structure	1
popular device	xd cards	1
handgun	xd's	1
connection type	xdsl	1
free online service	xdrive	1
broadband technology	xdsl	2
optical disk	xdcam hd	1
broadband application	xdsl service	1
company	xds	1
company	xdrive	1
memory type	xd picture card	1
rim	xd series rim	2
datum communication system	xdigital subscriber line	1
open protocol	xdnd drag-and-drop protocol	1
organization tool	xdcam explorer	1
flash card	xd	1
flash card	xd picture card	1
integrated device	xda	1
professional camera	xdcam	1
broadband network	xdsl network	1
J2EE technology	xdoclet	1
online storage service	xdrive.com	1
boolean operation	xdr	1
debugger	xdebug	1
flash memory card	xd	1
detailed topic	xdb performance tuning	1
memory card format	xd picture cards	2
memory card format	xd	1
memory card format	xd-picture card	1
java framework	xdoclet	1
pocket PC phone	xda ii	2
telecommunications product	xdsl modem	1
virtual system	xdsl lookup tools	1
big name sponsor	xdc	1
NLE system	xdcam	1
popular memory card	xd	2
exclusive korg feature	xds dual sequencer	16
exclusive korg feature	xds dual sequencer intuitive touchview interface	1
exclusive korg feature	xds dual sequencer intuitive touchview interface quarter-tone on-the-fly	1
good combination	xd nine mm with a hi-point  nine mm carbine 	2
9mm pistol	xd	1
internet access technology	xdsl	2
login manager	xdm	1
program	xdcam transfer	1
memory card type	xd picture card	1
online file storage service	xdrive	1
sony professional camcorder	xdcam tm series	1
sony professional camcorder	xdcam series	1
special-purpose language	xduce	1
command name	xdelta test	1
command name	xdelta printdelta	1
flash medium card	xd	4
high-quality format	xdcam  four : two : two  avc-i 	1
motion simulator	xd theatres	1
motion simulator	xd theater	1
professional series	xdl sportbike freestyle championship	1
rim & tire	xd extreme diesel	1
session manager	xdm	1
small card	xd card	1
wide area network solution	xdsl solution	1
widely-used technology	xdr for compact	1
XDMCP server	xdm	1
broacast format	xdcam	1
code profiler	xdebug	2
developer productivity feature	xdoclet integration	1
high-speed modem	xdsl	1
on-screen keyboard	xda keyboard	1
splitter part	xdsl micro filter	1
tapeless format	xdcam	1
amazing korg feature	xds dual sequencer	1
technique	xdsl	1
cloud-based storage solution	xdrive	1
display manager	xdm	1
flash memory card format	xd	1
great korg feature	xds dual sequencer	2
Long GOP codecs	xdcam ex	1
long-gop format	xdcam	1
non-essential bio feature	xd technology	1
speed line	xdsl	3
sweet korg feature	xds dual sequencer	1
XML transformation language	xduce	1
ADI series product	xdi	1
application enabler	xdm server	1
architecture-independent format	xdr	1
bit rate codec	xdcam ex	1
broadband facility	xdsl service	1
capable unit	xds	1
card standard	xd	1
commercial product format	xd card	1
deployment entity	xdc	1
FOSS solution	xds	1
frequency circuit	xdsl	1
high-cap gun	xd	1
high-speed access device	xdsl technology	1
high-speed datum communication	xdsl using the existing copper cable come into wide use	1
import tool	xde imports of rational software modeler	1
interactive simulator	xd theater	1
IPP client	xds plus	1
latest XD technology feature	xds	1
latest XD technology feature	xd picture	1
memory standard	xd	1
modern login manager	xdm	1
motion simulator s	xd theatres	1
non-tape format	xdcam	1
OMA supporting enabler	xdm	2
online storage player	xdrive technologies inc.	1
range toy	xd . fourty-five 	1
read card	xd	1
small form factor standard	xd-picture card	1
standard open source framework	xdoclet	1
straight edge band	xdeathstarx	1
sub-compact or compact polymer pistol	xd	1
option	xd kit available	2
third-party facilitator	xdc	1
WAN ON Internet device	xdsl modem	1
aluminum-made alloy wheel	xd series wheel	2
option	xd engine technology	1
breach pistol	xd	1
code-generation tool	xdoclet	2
consumer focused service	xdrive	1
datum communication transceiver	xdsl modem	2
debuger	xdebug	1
dedicated file storage service	xdrive	1
department topic	xd's corner	1
difficult and expensive proprietary format	xd card	1
emergence ofadvanced service	xdsl service	2
external datum representation strategy	xdr	1
external debugger	xdebug	1
feasible project	xdg menu	1
file-based medium	xdcam	1
full size semi	xd- fourty-five 	1
GUI login manager	xdm	1
helper technology	xdoclet	1
high-bandwidth access technology	xdsl	1
independent software product	xdr	1
jrun-specific capability	xdoclet	1
mobile specific site	xda dev	1
online file-storage service	xdrive	1
patented LG technological advance	xd engine	1
personal online storage solution	xdrive	1
PHP extension	xdebug	1
polymer-framed pistol	xd	1
popular open source design-time tool	xdoclet	1
remote storage service	xdrive	1
shared datum channel architecture	xdsl data architecture	1
standards-based communication	xds	1
sub-100mbps option	xdcam hd four hundred and twenty-two  @  fifty mbps 	1
suitable phone	xda from o  two 	1
syntactic definition	xdr	1
traditional protocol-building tool	xdr	1
unit-day value	xdollarsper visitor day ofcoldwater fishing	1
user-side communication apparatus	xdsl modem	1
tool	xdoclet	5
xda device	xda ignito	1
X-window interface generator	xdialog	1
technology	xdr for compact	12
technology	xdr	3
technology	xdsl	1
technology	xdsl system	1
technology	xd engine with fresh white feature	1
technology	xdoclet	1
technology	xdebug	1
technology	xdr for data transport	1
device	xda for web surfing	1
device	xda ii	1
site	xdrive	2
site	xda developers	1
related product	xd card reader related product	1
related product	xda atom pure related product	1
related product	xda pda related product	1
