accessory	xk eight  performance accessory 	1
accessory	xkr performance accessory	1
model	xk sports car	1
model	xk	1
website	xkcd wiki	1
website	xkcd in ebook format	1
standard	xkms	2
club	xkandalo in madrid	1
car	xk eight 	1
specification	xkms	1
board	xkcd forum	1
update	xkcd poster	1
performance accessory	xkr performance accessory	1
performance accessory	xk eight  performance accessory 	1
comic	xkcd	2
security issue	xkms	1
security standard	xkms	1
automatic weapon	xk two 	1
webcomics	xkcd	3
british car	xk jaguars	1
web comic	xkcd	1
certificate format	xkms responses	2
community	xkcd	2
web service security standard	xkms	1
exciting model	xk eight -r in the range 	1
natural well	xkeken cenote in mexico's yucatan	4
natural well	xkeken cenote in mexico s yucat n	1
natural well	xkeken cenote in mexicos yucatan	1
natural well	xkeken cenote in mexicos yucatn	1
classic jaguar	xk	1
non-peptide HIV-1 PR inhibitor	xk two hundred and sixteen 	1
non-peptide HIV-1 PR inhibitor	xk two hundred and sixty-three 	1
on-line approach	xkms	1
expensive british car	xk one hundred and twenty  through xk one hundred and twenty-five  model 	1
modern jaguar	xk	1
real camera	xk	1
XKB extension utility	xkbcomp	2
AdamJacobMuller.net	xkcd strip named wikipedian protester	1
building house company	xkt engineering	1
credential specific protocol handler	xkms	1
credential-specific protocol handler	xkms	1
Cunningham.ittoday	xkcd strip named wikipedian protester	1
popular online strip	xkcd	1
typical treatment planning system	xknife from radionics	1
