initiative	xstrata goedgevonden	1
initiative	xstar in the united states	1
accessory	xsara performance accessory	1
subject	xslt	2
attraction	xscape	2
client	xstrata	1
alternative	xstream	1
alternative	xslt	1
alternative	xs drink	1
alternative	xsd	1
mechanism	xsp	1
band	xscape	2
operation	xsl transformation	2
operation	xstrata's other operation	1
firm	xstrata	2
act	xscape	3
attribute	xstatus  one thousand eight hundred and fourty-one 	3
setting	xss filter	1
unit	xs series	1
policy	xsd validity	1
team	xsv	1
feature	xslt debugging	1
feature	xsan administration	1
improvement	xslt schema change	1
format	xslt-generated table	1
format	xsl-fo	1
big name	xscape	1
standard	xslt	9
standard	xsd	2
standard	xsl stylesheets	1
standard	xsl transformation	1
standard	xsl	1
advanced feature	xslt debugger	1
advanced feature	xsi's subdivision interpolation for texture uvs	1
club	xs	2
vendor	xsv	1
feature	xsd	1
issue	xss	2
module	xslt	1
module	xspf player	1
offer	xsi foundation	1
corporation	xstrata	1
language	xslt	11
language	xsl-fo	1
package	xsi	2
producer	xstrata	3
producer	xstrata plc	1
artifact	xsd file	1
issue	xss scripting	1
operator	xstrata	1
apps	xsi	1
stock	xstrata	1
sponsor	xstrata	1
rival	xstrata	1
threat	xss attack	3
threat	xsrf	3
specification	xslt	3
specification	xsl wg specification	1
command	xset command	1
investor	xstrata	1
drink	xs energy drink	1
code	xslt transformation sheet	1
advanced technology	xslt	2
big company	xstrata	2
attack	xss	10
attack	xsrf	2
library	xstream	1
interface	xshapedescriptor	1
camera	xsi	1
international company	xstrata	1
version	xsv	1
guideline	xsecondsperflap degree of retraction for acceleration before changing throttle	1
beverage	xs an gatorade	1
major	xstrata	1
product line	xsportz sunglasses	1
routine	xsetbackground function	1
big player	xstrata	2
extension	xsl	1
simple tool	xslt	1
modern technology	xslt	1
editor	xstandard xhtml strict	1
multinational	xstrata	1
industry giant	xstrata	1
browser	xscope pro	1
industry standard	xslt	1
performance accessory	xsara performance accessory	1
popular product	xs slim vibrator	1
processor	xsltproc	1
processor	xscale	1
cover	xs thristies	1
musical influence	xscape	1
file type	xsd	1
industry player	xstrata	2
security issue	xss	1
international standard	xslfo	1
international standard	xsl-t	1
script	xslt script	1
global player	xstrata	1
powerful tool	xslt	1
standard method	xss	2
laser	xsil laser	1
source material	xslt of a data view	1
weakness	xss	1
renowned company	xstrata	7
open standard	xslt	8
open standard	xsl	1
web technology	xslt	1
mine	xstrata's bajo del alumbrera	1
mine	xstrata's nickel rim	1
mining company	xstrata	9
mining company	xstrata plc	3
mining company	xstrata copper	1
mining company	xstrata ltd	1
cutting-edge technology	xslt	1
standard component	xslt processor	1
worm	xss worm	3
nightclub	xs	1
edge technology	xslt	1
common method	xss	1
large player	xstrata	3
ETFs	xsp	1
big name player	xstrata	2
vulnerability	xss	4
vulnerability	xss attack	1
vulnerability	xsf	1
miner	xstrata	12
miner	xstrata plc	3
core technology	xslt	2
professional team	xsv	1
celebrity friend	xscape	1
energy drink	xs energy drinks	1
apple product	xsan	1
markup language	xslt	5
newest technology	xsl	1
training provider	xs training	1
topic	xslt support	1
key customer	xstrata	1
standard technology	xslt	3
top club	xs	1
topic	xss redirect scripting	1
large producer	xstrata	1
web standard	xslt	1
comer	xs scuba	1
company	xstrata	19
company	xstrata plc	3
ISP	xs four all 	1
styling tool	xslt	1
equity	xstrata plc	1
processing tool	xslt processing tool	1
sport brand	xsn sport brand	1
company	xstrata coal	1
company	xstrata-merafe chrome venture	1
company	xstream	1
functional language	xslt	1
raid	xserve	1
super hero name	xs	1
company	xstrata nickel	1
company	xsens technologies	1
company	xsi sports insurance	1
company	xstrata copper	1
company	xs energy	1
company	xs energy drink	1
coal producer	xstrata holdings	2
nokia phone	xseries	1
leading industry player	xstrata plc	2
large cap	xstrata	1
mining stock	xstrata	2
open-source technology	xslt	1
music file	xspf	1
coal company	xstrata	1
XML technology	xslt	10
XML technology	xsd	1
large mining company	xstrata	2
simple setting	xst optimization style	1
mining firm	xstrata	1
XML standard	xslt	1
functional programming language	xslt	1
global heavyweight	xstrata	1
malicious attack	xss	1
security vulnerability	xss	1
repository object	xslt program	1
schema language	xsd	2
schema language	xsd schema	1
transformation tool	xslt	1
synthesis tool	xst	2
attack vector	xss	1
xml-based language	xslt	1
XML document	xsl-fo	3
view technology	xslt stylesheets	2
XML application	xslt	2
XML application	xsl formatting objects	2
active attack	xst	1
xml-based standard	xslt	1
mining house	xstrata	1
ubuntu vulnerability	xserver	1
datum processing function	xslt function	1
entry level DSLR	xsi	1
external utility	xsl script	1
resource group	xstrata	1
XML tool	xslt	1
XML tool	xslt and xml-query	1
Canon Digital SLRs	xsi	1
common vulnerability	xss	1
introduction activity	xslt schema support	1
file structure	xsl	1
intermediate language	xsl-fo	1
template engine	xslt	1
web application vulnerability	xss	1
XML language	xslt	2
big miner	xstrata	1
client solution	xsupplicant	1
failure analysis technique	xsectioning	1
host language	xslt	2
XML query language	xslt	2
copper producer	xstrata	1
female group	xscape	1
global mining company	xstrata	1
third-party content provider	xsight	1
companion standard	xsl	1
HR department	xstratacoal sa	1
large miner	xstrata	2
large miner	xstrata plc	1
shared file system	xsan	1
world largest mining company	xstrata	1
XML parsers	xsv	1
XSLT processor	xsltproc	3
declarative programming language	xslt	1
front-end technology	xslt	1
injection attack	xss	1
mining share	xstrata	5
operational file	xslt files for notification formatting	1
program	xss proxy	1
xml-based technology	xslt	2
android browser	xscope	1
program	xsi from softimage	1
sector heavyweight	xstrata	1
service object	xsl proxy	1
special-purpose language	xslt	1
template language	xslt	1
XML processing task	xsl transformation	1
xml-derived markup language	xslt	3
citroen model	xsara	1
diversified miner	xstrata	2
experienced and established team	xsf	2
input validation vulnerability	xss	2
large and popular attraction	xscape	1
london-listed miner	xstrata	2
platform-neutral standard	xsd	2
view engine	xslt	1
web query language	xslt	4
XML conversion service	xsd to xml	1
XML query declarative language	xsl	1
XML related technology	xslt	2
XML related technology	xsl stylesheet	1
xml-related technology	xslt	1
basic XML tool	xslt	1
big mining house	xstrata	2
configuration device	xserve raids	1
established miner	xstrata	1
established rapper	xscape	1
giant global player	xstrata	1
large mining group	xstrata	1
markup standard	xslt	1
modern software engineering technology	xslt	1
modern software engineering technology	xsd	1
open, platform-independent, technology	xslt	1
performance goodie	xs power stainless steel longtube header	1
polysoup modeling package	xsi	1
organization	xstrata	1
region large mining company	xstrata	1
SAN file system	xsan	2
screen capture option	xsplit's internal capture	1
supply constraint major mining company	xstrata	1
technical model	xsd	1
technologes	xsigo systems	1
transnational mining company	xstrata	1
western mining company	xstrata	1
world's giant mining stock	xstrata	1
world's largest producer	xstrata	1
xml compliant language	xsl-fo	1
absence vulnerability	xss	1
accompanying standard	xslt	2
afamilyofin-dustry-standard software function	xsl transformation	1
android web browser	xscope	1
common web development technology	xslt	1
conventional web query language	xslt	2
copper company	xstrata	2
dedicated technology	xslt	1
fitness center chain	xsport fitness	2
technique	xsl attack	1
global diversified miner	xstrata	1
industry's biggest global player	xstrata	1
large coal producer	xstrata	1
logic programming system	xsb	2
long standing classic	xsb	1
main-stream web query language	xslt	1
modern schema language	xsd	3
real world attack vector	xss	1
real world vector	xss	1
resource client	xstrata	1
application	xslt processor	1
application	xsl transformer	1
application	xslt	1
today's foremost XML technology	xslt	1
transformation technology	xslt	1
web service leverage standard	xsd	2
XML transformation language	xslt	3
advanced and established technology	xslt	1
armv5te processor	xscale	1
Basic mapping technology	xslt	1
basic XML concept	xsl file	1
browser-based attack	xss	2
application	xserver-xorg xorg gnome-session metacity compiz	1
name	xs	2
client-side vulnerability	xss	1
common application attack	xss	1
common hacker attack vector	xss	1
complex vulnerability	xss	1
declarative transformation language	xslt	1
domain specific standard	xslt	1
easily exploitable flaw	xss	1
elementary security concept	xsrf	1
name	xstream	1
fault injection vulnerability	xss	1
front site	xs big dot	1
generic XML tool	xslt	1
global mining giant	xstrata adr	3
high end vegas club	xs	1
high-end arcade	xs orlando on international drive	1
innovative digital technology	xsens mvn system	1
javaml grammar file	xsd file	1
logic database	xsb	1
long pipeline core	xscale	1
milton keynes attraction	xscape centre	1
obscure android browser	xscope	1
offshore miner	xstrata plc	1
popular xml-based technology	xslt for content transformation	1
case	xstrata plc's acquisition of mim holdings limited	1
case	xslt	1
case	xstrata	1
premium energy drink	xs energy shots	1
premium energy drink	xs gold	1
programmable transformation framework	xslt	1
queensland coal producer	xstrata	1
rival diversified mining company	xstrata plc	1
rule-based language	xslt	1
satellite XML technology	xsl template	1
shenhua beat company	xstrata in the bidding for the permit	1
standard XML processing tool	xslt	1
standard XML tool	xslt processors into arbitrary final form	1
Stylesheets	xsl stylesheets	2
case	xslt three  template language 	1
tip cover area	xsl match template	1
transformation standard	xslt	1
UI engine	xslt	1
utilized various technology	xsl transformations	1
variable datum printing software application	xstream	1
vegas nightclub	xs	1
vegas nightclub	xs night club located at the beautiful encore hotel	1
world's top miner	xstrata	1
XML control document	xsd file	1
XML manipulation tool	xslt	1
XML-to-Java serialization library	xstream	1
XSD object	xsd element	1
alloy producer	xstrata	1
Apple Event	xserver	1
AQNamemayhavea prefix	xsl	1
bolt-on technology	xslt	1
canon's older lower-cost camera	xsi	2
coal group	xstrata	1
command-line XSLT processor	xsltproc	1
commodity credit	xstrata	1
commodity-related credit	xstrata	1
common web application flaw	xss	1
conventional SMIL browser	xsmiles	2
corresponding technical model	xsd	1
corresponding technical resource	xslt script	1
datum model transformation technology	xslt	4
Descriptor translation information	xsl transformation language	2
developer mistake	xsf	1
option	xsun distribution	1
existingxml transformation technology	xslt	1
fiber channel RAID system	xserve raid	1
FLR stock assessment model	xsa	1
fundamental ESB service	xslt transformation	1
genetic immunodeficiency disease	xscid	1
HDL synthesis tool	xst	1
high-level approach	xslt	1
Hydrophilic aminosilicones	xs sixty-nine -b five thousand four hundred and seventy-six  with alkoxyl group 	1
image scanner program	xsane image scanner	1
inspection service company	xspect solutions measure customer part	1
interoperable approach	xslt	1
INTRODUCTION multimedia client-server system	xserver-client-based multimedia system	1
lightweight XSLT processor	xsltproc	1
localization matter	xseed	1
lower-level tool	xsltproc	2
micro satellite	xss- eleven 	1
Micro-satellites	xss- eleven 	1
modern logic database	xsb	1
modern low-power embedded processor	xscale	1
non-database application	xsl processor	1
non-network related attack	xss	1
overlay interface	xs on the ground	1
production gun	xse ltw commander	1
reputable schema processor	xsv	1
serialisations	xsl	1
single weight pocket	xs-scuba weight pocket	1
ski dome	xscape castleford in yorkshire	1
small, dense file	xslt script	1
syntactic transformation language	xslt	1
template technology	xslt	1
througha transformation language	xslt	1
traditional transformation framework	xslt	1
tree filter programming language	xslt	1
tree-based transformation engine	xslt	1
typical vulnerability	xss	1
tool	xslt	6
tool	xslt debugger	2
VPA derivative	xsa	1
web-based vulnerability	xss	1
withxml transformation	xslt	1
xbox live event	xsn sports world championship	1
XML related format	xsl	1
XML transformation	xslt	1
XSL WG specification	xslt	1
tool	xslt stylesheets	1
tool	xsl transformation map editor	1
tool	xslt editor	1
tool	xslt ide	1
tool	xslt processing tool	1
tool	xsl-fo	1
project	xss- eleven 	1
project	xsport fitness	1
artist	xscape	2
player	xstrata	1
technology	xslt	18
technology	xsd	2
product	xs energy drink	2
technology	xslt transformation	1
term	xsd	1
term	xsrf	1
term	xss	1
brand	xs	1
brand	xsn sport brand	1
component	xslm license manager	1
aspect	xslt  two . zero 	1
