product	yby eight hundred  charger 	1
attraction	ybor city	1
category	ybor zoning designation	1
location	ybor city in tampa	2
location	ybor city	2
business	ybor city cigar factory	1
venue	ybor city state museum	2
compound	ybincu  four 	1
figure	ybarra	1
big name	yb datuk seri mohd shafie apdal	1
club	ybs	1
key item	ybor city economic	1
local attraction	ybor city	1
database	ybase	1
city attraction	ybor city museum state park	1
goodie	ybn halflinks	1
aircraft	yb- fourty-nine 	1
metal	yb	1
comment	ybmkvh watch movies online pdpfrgv	1
area	ybor city	6
node	ybeforeremoving the edge	1
rock band	yb	1
area	ybs	1
tablet	ybc  seven thousand two hundred and eighty-nine 	1
metal oxide	yb two o three 	1
soldier	ybarra	1
amp	yba	1
lewis acid	yb  three 	3
lewis acid	ybcl  three 	1
lewis acid	yb  three  in catalytic amount 	1
high-profile artist	yba chris ofili	1
rare earth element	yb	3
production tool	yb!pro design library	1
high profile area	ybor city	1
file manager	ybrowser	1
company	yba	1
company	ybrant digital	1
well-known area	ybor city in tampa	1
local area attraction	ybor city	1
workshop activity	yba	1
entertainment district	ybor city	1
superconducting material	ybco	1
HTS material	ybco	4
case only rare earth oxide	yb two o three 	1
epitaxial complex oxide	yba two cu three o seven 	1
googling name	yb	1
high-temperature superconductor	ybco	2
high-temperature superconductor	ybacuo	1
association board	ybc	1
community	ybor city	1
organization	ybs	1
fascinating commercial property	ybor city's cuban club	1
lanthanide f-ions	yb	1
well-known domestic zipper company	ybs ycc	1
Bulk RE borides	yb . sub . two 	1
Bulk RE borides	yb . sub . four 	1
Bulk RE borides	yb . sub . six 	1
famous korean star	yb	1
high tc superconductor	ybco	2
high temperature superconductor	ybco	1
high temperature superconductor	ybco by laser ablation	1
local bike show	ybor city	1
low volume station	ybor	1
manyfamiliar location	ybor cityin tampa	1
traditionally industrial area	ybor	1
balance bike	ybike balance bike	1
balance bike	ybike extreme	1
ceramic superconductor	ybacuo	1
excellent olive oil	ybarra	1
historically appropriate material	ybor's signature fi ve-globe light	1
introduction superconducting material	ybco	1
lanthanidef-ions	yb	1
case	ybarra	2
penninic flysch unit	ybbsitz zone	1
single crystal high Tc superconductor	ybco	2
superconductor material	ybco	1
tampa bay area attraction	ybor city	1
top korean rock group	yb	1
trendy nightlife area	ybor city	1
YDF parameter	yb concentration	1
ANetTekSeries instrument	ybt two hundred and fifty  field transmitter &interference tester 	1
bi-layer system	ybco	1
bulk high temperature superconducting material	ybco pellet	1
chef medina's restaurant	yb	1
codoped glass	ybler-codopcd glass	1
depositing superconductor	ybc onto an alumina substrate	1
group	yba	1
group	yb providence	1
flying wing	yb- fourty-nine 	1
high temperature ceramic superconductor	ybacuo	1
high-t c superconductor	ybco	1
high-temperature superconductivity material	ybacuo	1
laser amplifier	yb-doped multimode fibers pumped by a diode-laser array	2
long-standing cuban-american community	ybor city	2
massive scandal	ybm magnex international	1
orthorhombic superconductor	ybco	2
oxide superconductor	yba.sub. two  cu.sub. three  ox 	1
plastic balance bike	ybike balance bike	1
potential magnet grade superconductor	ybco	1
p-type superconductor	ybco	1
sailing forum	ybw	1
stateassemblymen	yb ronnie liu	1
superconducting ceramic precursor material	yba.sub. two  cu.sub. three  o.sub. seven -x powder 	2
symmetrical electrode	ybco on top	1
touse superconductor	ybco	1
product	yb cb ck fifty-one  gift sets 	5
product	ybacca fifty-one  gift sets 	5
project	ybor city	1
material	ybco film	1
material	ybacuo	1
material	ybc	1
place	ybor city	1
parameter	yb-ions concentration	1
system	ybco	1
brand	yb pennzoil	1
brand	ybn chain	1
aspect	ybc o crystal structure	1
