initiative	yct's golden stream corridor	1
initiative	ycf-funded legacy initiative	1
model	yc- one   one hundred and seventy-five 	1
client	ycn	2
client	ycn creating bold	1
person	yc wong	1
format	ycbcr	2
format	yc b c r	1
format	yc bc.sub.r	1
restaurant	yc's mongolian restaurant	1
party	ycl	1
association	ycs	1
space	ycbcr	2
charity	ycr	1
survey	ycs	1
offence	ycja-related offence	1
input datum	ycbcr datum	1
youth organization	ycl	1
accelerator	ycombinator	1
service	ycc bass dvd library	1
lewis acid	ycl  three 	1
image processing	yc correction	1
investment company	yci	1
digital format	ycc	1
home builder	ych communities	1
educational institute	ycce	1
color space	ycbcr	8
color space	yc b c r transformed from the rgb space	1
color space	yc.sub.b c.sub.r hsv	1
incubator	ycombinator	2
incubator	yc	1
company	ych	1
company	ycombinator	1
youth event	yc	1
top-quality brand	ycp pistons	1
parachurch organization	ycw	1
color system	yc b c r	1
color model	ycbcr	1
year college	yc	1
video capability	yc capability	1
host artist	yc	1
event	ycs	1
event	ycc's bangbang brief night	1
event	yc newfoundland	1
industrial honcho	yc deveshwar	1
characteristic form	ycrticordia	1
accelerator program	yc	3
accelerator program	ycombinator	1
annual goal	ycpo program	1
program	ycombinator	1
rare earth chloride	ycl three 	2
color display system	ycc system	1
incubator program	yc	1
obsolete word	yclept	9
organization	ycombinator	1
TV output	ycbcr output	1
arecolor space	ycbcr	1
district section	ycu	2
orthogonal color space	ycbcr	1
name	yc	1
kerning pair	yc	1
local 3PLs	ych	1
luminance-chrominance space	ycbcr	1
output various format	ycbcr	1
scale tournament	ycs	1
splicing factor binding site	ycay sites for nova	2
startup incubator	ycombinator	1
tactical transport aircraft	yc- fourteen 	1
association level	ycm	1
CBL system	ych	2
group	ycs	1
head scratchers	yclept	1
large airplane application	yc- fourteen  bulkhead 	1
luminance-color format	yc r c b	1
precious native species	yct	1
Resident Nepalis	ycl	1
seed program	ycombinator	1
method	ycbcr one  fig 	1
method	ycbcr	1
traditional video color space	ycbcr	1
artist	yc	1
artist	yc aka yung chris	1
component	ycbcr	1
