initiative	yds	1
opportunity	ydp	1
scheme	ydnpa barns	1
environment	ydc	1
line	ydp	1
enterprise	yds enterprises inc.	1
programme	ydsp	1
electronic component	yds's electronic component	1
oxide	ydc	1
descriptive name	ydtu	1
company	ydp	1
subfamily	yd three 	2
usernames	ydouask	1
usernames	ydoucare	1
19th century writer	yda addis	1
19th-century writer	yda addis	2
program	ydp	1
WLAN device	ydi usb antenna	1
WLAN device	ydi diamond wlan card	1
employment situation	ydc	1
quality name brand manufacturer	ydi	1
chain saw crankshaft	yd sixty-two 	1
basic brown	ydk	1
external Bandwidth Manager	ydi bcu	1
Hsp40s	ydj one  from s. cerevisiae 	1
multimedia supplier	ydp	1
quality engine	yd	1
theologically pluralistic community	yds	1
component	yds's electronic component	1
