product	yharnessesused with a booster base	1
disease	yhd	1
individual	yh	1
Organisations	yha	1
piece	yhm dual-rail gas block	1
piece	yhm specter	1
historian	yh yerushalmi	1
god	yhwh	1
reliable brand	yhm	1
trading partner	yha	1
voluntary sector organization	yha	1
company	yhm making a shoddy product	1
low place	yha hostel	1
discount card	yha	1
local study	yhap research	1
front sight	yhm	1
merit-based scholarship	yhc academic scholarships	1
rival chain	yha	1
organization	yha	1
big international chain	yha	2
name	yhwh	2
front site	yhm	1
personal suffix	yhwh elohay	1
biggest hostel chain	yha	1
good hostel	yha brisbane	1
infor	yh key id	1
low profile gas block	yhm	1
sensitive male	yhb	1
transcending being	yhwh	1
product	yh- twenty-eight  medical pressure-sensitive adhesive 	1
brand	yhm	1
