field	yk	1
manufacturer	ykk	1
basic	ykk zipper	1
improvement	ykk zipper	1
brand name	ykk	2
brand name	yks	1
supplier	ykk	1
international company	ykk	1
hardware	ykk zipper	1
department store	ykm	1
high quality material	ykk zipper	1
controller	yk fourty-two  from tncscooters .com 	1
multi-national company	ykk	1
top quality material	ykk zipper	2
top quality material	ykk buckle	1
manga	ykk	1
key supplier	ykk	1
italy tv channel	yks	1
genuine material	ykk zipper	1
company	ykk architechural products	1
company	ykk	1
trademark owner	ykk	1
top-brand manufacturer	ykk	1
high-spec material	ykk zipper	1
mil-spec material	ykk zipper	1
zipper manufacturer	ykk zippers	2
curtainwall company	ykk ap	2
airtight zipper	ykk tznc.tm	1
branded zipper	ykk	1
distinct burton feature	ykk zipper	2
indoor shopping option	yk centre	1
regional health care organization	ykhc in bethel	1
material	ykk zip	1
player	yk	1
product	ykk zipper related product	1
