datum	ytd	1
source	ytterbium	1
model	yth six thousand three hundred and twenty r one thousand and fifteen  kit 	1
client	yto international	1
strategy	yttrium synovectomy	1
agent	yttrium	1
agent	yttrium oxide	1
manufacturer	yto group corporation	1
compound	ytrium barium copper oxide compound	1
website	ytmnd	1
policy	yts	1
substance	yttrium gadolinium iron garnet	1
scheme	yts	1
additive	yttria	5
additive	yttrium	3
additive	yttrium oxide	2
additive	ytterbium	2
asset	ytv	1
report	ytd earnings ledger	1
report	ytd measure	1
machine	yt messerschmitt bf- one hundred and nine 	1
channel	ytv	3
track	ytse jam	1
aid	yttrium oxide	2
programme	ytsara spa wellness programme	1
mineral	yttrian fluorite	1
metal	yttrium	17
jurisdiction	yt	1
impurity	yttria	1
large corporation	ytl group	1
light source	yttrium aluminum garnet laser	1
coating	yttria	1
ship	yt- one thousand three hundred 	1
fiber	yttria	1
specialty service	ytv	1
by-products	yttrium	1
derivative	ytreatmentwitha tetracycline derivative	1
host	yttrium lithium fluoride	1
stones	yttrium fluorite	1
mark	ytong	1
ion	ytterbium	1
rapper	ytcracker	1
financial information	ytd percentage change	1
powder	yttria	1
subsidiary	ytl power international bhd	1
subsidiary	ytl power int'l	1
oxide	yttria	4
oxide	yttrium oxide	4
oxide	ytterbium oxide	1
oxide	yttrium	1
oxide	yttrium barium copper oxide	1
notable artist	ytcracker	4
treatment method	yttrium y ninety  sphere infusion 	1
stabilizer	yttria	7
broadcaster	ytv	1
antibody	yttrium  ninety -ibritumomab tiuxetian 	1
peptides	yttrium- ninety -labeled synthetic somatostatin analog 	1
call	ytb cockatoo	1
multinational corporation	ytl	1
metal oxide	yttrium oxide	3
metal oxide	yttria	1
metal oxide	yttrium	1
crystal	yttrium gallium garnet	2
crystal	yttrium aluminum garnet	1
crystal	yttrium boride	1
ceramic	yttria	4
ceramic	yttrium aluminum garnet	1
precursor	yttrium hydroxide	1
precursor	yttrium nitrate	1
radionuclides	yttrium- ninety 	1
minor component	yttrium	1
ceramic material	yttria	2
ceramic material	yttrium-barium-copper oxide	1
isotope	yttrium- ninety 	2
isotope	yttrium	1
cation	yttrium	1
dopants	ytterbium	2
dopants	yttrium	2
dopants	yttrium oxide	1
dopants	yttria	1
atom	yttrium	1
active element	yttrium	1
radioisotope	yttrium- ninety 	2
radioisotope	yttrium	1
sire	ythanbrae n thirty-three 	1
product name	ytong	1
prominent name	ytl	1
refractory material	yttria	1
radiation source	ytterbium- one hundred and sixty-nine 	1
glove	yty industry's glove	1
wellness program	ytsara spa wellness program	1
monoclonal antibody	yttrium y  ninety  ibritumomab tiuxetan 	4
TV station	ytv	1
popular channel	ytv	1
video site	ytb	1
message board	ytmnd	1
plugin	ytv	1
chemical element	ytterbium	1
alternate material	yttrium oxide	1
non-ferrous metal	yttrium	1
chloride	yttrium chloride	4
heavy element	yttrium	1
metallic element	yttrium	3
gene product	ytf three  protein 	1
nuclides	yttrium- ninety 	1
ferromagnetic material	yttrium iron garnet	1
fission product	yttrium- ninety-one 	1
rare earth element	yttrium	21
rare earth element	ytterbium	4
rare earth element	yttrium oxide	1
reactive material	yttria	2
fluoride	yttrium fluoride	1
business name	yth vacation	1
strange name	yttrium	1
company	ytl comm	1
company	yto group corporation	1
reactive element	yttrium	15
buffer layer	yttrium oxide	2
refractory oxide	yttria	3
refractory oxide	yttria-stabilized zirconia	1
company	ytl cement	1
rare mineral	yttrofluorite	1
metallic ion	yttrium	1
beta emitter	yttrium- ninety 	4
beta emitter	yttrium	1
rare earth metal	yttrium	3
rare earth metal	ytterbium	2
additive element	yttrium	2
intracellular structure	ytokines	1
large cap	ytl corp bhd	1
quality model	yt	1
radioactive source	ytterbium- one hundred and sixty-nine 	1
metal silicides	yttrium	1
transitional metal	yttrium	1
chemical modifier	yttrium	1
fluorescent material	ytterbium	1
metal fluoride	yttrium fluoride	2
activity	yt event	1
rare earth oxide	yttrium oxide	2
rare earth oxide	yttria	1
rare earth oxide	ytterbia	1
rare earth oxide	ytterbium	1
column header	ytd	1
crystalline substance	yttrium orthovanadate	1
impurity ion	ytterbium	1
rare earth mineral	ytterbium	1
rare earth mineral	yttrium	1
Short-lived radionuclides	yttrium- ninety 	5
independent power producer	ytl power	3
sintering aid	yttria	6
sintering aid	yttrium oxide	2
rare earth	ytterbium	27
oxide ceramic	yttria	1
elemental metal	ytterbium	1
solid-state laser	ytterbium-doped yttrium aluminum garnet	1
radioactive tracer	yttrium- ninety 	1
radioactive tracer	yttrium- eighty-nine 	1
rare earth material	yttrium	1
doping element	yttrium	2
rare-earth element	ytterbium	1
birefringent crystal	yttrium vanadate	1
IPPs	ytl power	2
semiconductive metal oxide	yttrium	2
single crystal	yttrium-aluminum garnet	1
single crystal	yttrium-iron garnet	1
metal oxide layer	yttria-stabilized zirconia	2
optical crystal	yttrium aluminum garnet	1
refractory metal oxide	yttria	1
aluminide-modifying element	yttrium	4
complex oxide	yttrium oxide	1
reactive and noble aluminide-modifying element	yttrium	2
high vibration stones	yttrium fluorite	1
solid electrolyte	ytria-stabilized zirconia	1
solid electrolyte	yttrium-stabilized zirconia	1
trivalent element	yttrium	1
oxide powder	yttrium oxide	1
transparent or translucent material	yttria	2
electropositive element	yttrium	1
alkaline earth metal inorganic salt	yttrium	2
beta-emitting isotope	yttrium- ninety 	2
rare-earth metal	yttrium	1
ultra-trace element	yttrium	1
beta-emitters	yttrium- ninety 	1
beta-emitting radionuclides	yttrium- ninety 	1
event	ythan games	1
inert support material	yttria-stabilised zirconia	1
oxide single crystal	yttrium aluminium garnet	1
oxide single crystal	yttrium aluminum garnet	1
oxide single crystal	yttrium orthovanadate	1
canadian network	ytv	1
dielectric constant material	yttria	2
program	yts	2
pure beta emitter	yttrium	1
pure beta emitter	yttrium- ninety 	1
commercially available oxide	yttrium oxide	1
high-temperature superconductor	yttrium barium copper oxide	1
Oxide nanoparticles	yttrium oxide	1
oxide particle	yttrium oxide	3
program	ytsara spa wellness program	1
program	ytalk on the unix system with ncsa telnet program	1
rare earth product	yttrium-rich earth	1
REEs	yttrium	1
ceramic-based material	yttrium oxide	1
lanthanide element	yttrium	2
specialised source	ytterbium	1
ceramic composition	yttria-stabilized zirconia	1
high end specialized treatment	ytrium for hcc	1
high profile malaysian corporate figure	ytl corporation managing director francis yeoh	1
high unit value rare metal	yttrium	1
inert, non-toxic radiopaque material	ytterbium fluoride	2
oxide ceramic coating	yttria	1
rare-earth dopant	ytterbium	4
reference element	yttrium	1
standard coating	yttria-stabilized zirconia	1
therapeutic radionuclides	yttrium- ninety 	1
unpronounceable name	ytterbium	2
anhydrous salt	yttrium chloride in pure ethanol	2
group IIIB metal	yttrium	1
heavyweight wimax operator	ytl	1
high-strength dielectric material	yttrium aluminium garnet	1
intermediate phase	yttrium aluminum perovskite	1
intermediate phase	yttrium aluminum monoclinic observed in the sintering process	1
local wildlife group	ythan amenity trust	1
low work-function metal	yttrium	2
metal oxide buffer layer	yttria-stabilized zirconia	3
organization	yta	1
precursor isotope	yttrium- eighty-nine 	3
rare and toxic element	yttrium	1
wear-resistant metal	yttrium	1
well-known local developer	ytl	2
x-ray-opaque filler	ytterbium fluoride	3
x-ray-opaque filler	ytterbium trifluoride	1
zirconias	yttria-stabilized zirconia	1
big guest	yt	1
codopants	ytterbium	1
Element s	yttrium	1
technique	yttrium aluminum garnet	1
Group IIIa element	yttrium	2
inbuilt date MDX function	ytd	1
intercalated metal	yttrium	2
magneto-optic material	yttrium iron garnet	1
MDX function	ytd	1
name album	ytmnd soundtrack	1
opants	yttrium	1
oxygen active element	yttrium	1
portfolio feature	ytd return	1
radiolabeled monoclonal antibody	yttrium y  ninety  ibritumomab tiuxetan 	2
rare earth addition	yttrium	1
Rare-earth metal oxide	ytterbium oxide	1
Rare-earth metal oxide	yttrium oxide	1
rare-earth oxide	ytterbium oxide	1
sesquioxide ceramic	yttrium oxide	1
short-lived radio nuclides	yttrium- ninety 	1
single crystal oxide	yttria-stabilized zirconia	3
application	yttrium-iron-garnet oscillator	1
tetracycline derivative	ytreatmentwitha tetracycline derivative	1
thermal barrier coating	yttria stabilized zirconia	1
vendor year-to-date accumulator field	ytd purchases	1
vendor year-to-date accumulator field	ytd payments	1
well-known super-ionic ion	yttria-stabilized zirconia	1
YouTube video splitter application	yt splitter	1
absorbed glass mat battery	ytx fourteen ah-bs all-terrain vehicle battery 	1
alternate envelope material	yttria	1
beta particle emitter	yttrium- ninety 	1
bond coat additive	yttrium	1
bond inhibiting material	yttrium aluminum oxide	4
builtin time series member	ytd	1
built-in time series member	ytd	1
name	ytterbium	2
disk laser	ytterbium disk laser	1
distorted compound	ytio  three 	1
emerging outfit	ytl land	1
essentially site	yt	1
name	ytd high beta name	1
name	yttrium	1
formally trivalent element	yttrium	1
great career exhibit	yti career institute	1
hi-tech chatrooms	ytalk	1
largest BBS site	ytht	1
lead-calcium battery	yt	1
nerdcore mainstay	ytcracker	1
non-siliceous filler	ytterbium trifluoride	2
oxide phosphor	yttrium aluminate activated with cerium	1
oxygen-ion conducting electrolyte	yttria-stabilized zirconia	1
paramagnetic lanthanide ion	ytterbium	1
case	yttrium	1
radiolabeled anti-cd20 monoclonal antibody	yttrium- ninety  ibritumomab 	5
rare earth s	yttrium	1
remarkable contemporary photographer	yto barrada	1
remote and abandoned chukchi site	yttygran island	1
scintillating phosphor	yttrium oxysulfide	1
sintering aid oxide	yttria	1
superconductor material	yttrium barium copper oxide	1
therapeutic beta-emitters	yttrium- ninety 	1
toxin group	ytx	1
transarterial locoregional therapy	yttrium- ninety  radioembolization 	1
uranium ome chemical element	ytterbium	1
user various stat	ytd profit	1
valent dopants	yttrium	1
video internet site	yt	1
x-ray opaque filler	ytterbium trifluroide	1
zirconia phase stabilizer	yttria	2
agm-type battery	ytz fourteen s battery 	1
aliovalent dopants	yttrium	1
alloy containingrare earth element	yttrium	1
beta-particle-emitting substance	yttrium- ninety  used in zevalin 	1
calculated member	ytd	2
canadian broadcast station	ytv	1
ceramic nanopowders	yttrium oxide	1
children's fare	ytv	1
common solid state laser system	yttrium aluminum garnet doped with neodymium	2
costly ceramic coating	yttria-stabillzed zirconium oxide	1
coupled radioisotope	yttrium- ninety 	1
crystalline erbium host	yttrium lithium fluoride	1
Cubic ferrites	yttrium iron garnet yig	1
cytologically marked Y chromosome	ytu-n chromosome	1
Doped zirconias	yttria-stabilized zirconia	1
ferrite oscillator	yttrium-iron-garnet oscillator	2
first metal oxide	yttria	1
fluoride host	yttrium lithium fluoride	1
generation independent power producer	ytl power	1
High temperature superconductor material	yttrium barium copper oxide	1
high-productivity model	yts fourty-five  separating yard twin-lift 	1
high-temperature superconducting material	yttrium-barium-copper oxide	1
independent unemployment fund	ytk	1
introduction crystal	yttrium aluminum garnet	1
introduction solid oxide ionic conductor	yttria-stabilized zirconia andgadolinia-doped ceria	1
lab-created garnet	yttrium aluminum garnet	1
lanthanoid alkoxides	yttrium isopropoxides	1
laser rod	yttrium aluminum garnet crystal doped with neodymium ion	1
magneto-optic garnet	yttrium iron garnet	1
Malaysian wimax telcos	ytl communications	1
manpower service commission's scheme	yts	1
MDX time-related function	ytd	1
modified light freighter	yt- one thousand three hundred  light freighters with additional external cargo pod 	1
MRT beneficiary	ytl land	1
POB ship	yt- one thousand three hundred 	1
radio-labeled antibody	yttrium- ninety  ibritumomab tiuxetan 	1
rare earth garnet	yttrium aluminum garnet	1
rare earth iron garnet	yttrium iron garnet	1
rare earthelement	yttrium	1
rare-earth iron garnet	yttrium iron garnet	1
rare-earth oxide addition	yttrium oxide	1
reactive rare earth metal	yttrium	1
REE metal	yttrium	1
roller rocker	yt	1
second ion	ytterbium	1
second metal oxide	yttria	1
secondmetal oxide	yttria	1
short-livedradionucl ides	yttrium- ninety 	1
single crystalline oxide	yttria-stabilized zirconia	1
solid oxide electrolyte material	yttria-stabilized zirconia	1
standard key figure	ytm	1
state-based quasi-apprenticeship system	yt	1
superconducting mixed metal oxide	yttrium barium copper oxide	1
thermal-barrier coating material	yttria-stabilized zirconia additional thermal-barrier quality	1
toronto area airport	ytz	1
artist	yt	1
material	yttrium	9
material	yttrium oxide	7
material	yttria	4
material	yttrium garnet	2
material	yttrium aluminum garnet	1
material	yttrium orthoaluminate	1
material	yttrium iron garnet	1
material	yttrium barium cuprates	1
material	yttrium fluoride	1
material	ytterbium oxide	1
material	yttrium-reinforced zirconia	1
material	ytterbium	1
material	ytrium barium copper oxide	1
place	yt	1
player	ytl communications	2
player	ytl e-solution	1
player	ytl corp	1
system	yttrium iron garnet	1
system	yttrium aluminum garnet	1
condition	ytc state	1
element	yttrium	37
element	ytterbium	1
element	yttrium oxide	1
function	ytd	1
brand	ytong	2
site	ytmnd	1
