product	yves veggie	1
ophthalmologist	yvette jockin	1
ophthalmologist	yvette m jockin	1
exception	yvette	1
character	yvonne lam	1
model	yve-alain bois concept of mourning	1
client	yves saint laurent	1
client	yves st.laurent	1
author	yvanand claire goll	1
author	yvonne dolan	1
author	yves jouffe	1
form	yvain	2
person	yvonne	2
person	yvonne brewester	1
person	yvonne coke of hands across jamaica for righteousness	1
alternative	yves deli slice	1
location	yverdon	1
writer	yvonne vera	1
writer	yves bonnefoy	1
writer	yvon chouinard	1
star	yvonne de carlo	1
star	yvonne catterfeld	1
star	yves	1
star	yves montand	1
star	yvonne catterfield	1
band	yves klein blue	1
food	yvette bender can food	1
title	yvain	1
celebrity	yvon lambert	2
celebrity	yvonne lim	1
celebrity	yves montand	1
celebrity	yves st laurent	1
town	yverdon-les-bains	1
town	yvoire	1
favorite	yves carradine	1
favorite	yvonne jentszch	1
act	yves larock	1
man	yves conger	1
publication	yvr flyer	1
individual	yvon chouinard	1
individual	yvonne harris	1
leader	yvon chouinard nell newman amy domini	1
musician	yves robert	1
musician	yves nat	1
song	yvonne chaka chaka's	2
researcher	yves ternon	1
big name	yves saint laurent	4
vendor	yves delorme	1
store	yves saint laurent	1
label	yves saint laurent	7
label	yvonne black	2
label	yves saint lauren	1
designer	yves saint laurent	49
designer	yves st. laurent	9
designer	yves behar	3
designer	yves saint-laurent	2
designer	yves saint laurant	1
designer	yves saint lauren	1
designer	yves jean lacasse	1
designer	yvette lynette lax	1
student	yves lamontagne	1
student	yvonne kwong of hong kong	1
woman	yvette ellis-clark	1
woman	yvonne rudelat	1
woman	yvonne macrae	1
woman	yvonne	1
woman	yvonne bennett	1
speaker	yvonne ridley	1
performer	yvonne strahovski	2
performer	yvonne kubicek	1
brand name	yves rocher	1
brand name	yves saint laurent	1
legend	yvonne chaka	1
great	yves saint laurent	1
luminary	yves behar	1
luminary	yvonne craig	1
university	yvy league research university	1
friend	yvette	1
issue	yves saint laurent replica compensation	1
top brand	yves saint laurent	1
athlete	yvonne delaney	1
shop	yves saint laurent	1
theorist	yvan craipeau	2
theorist	yve-alain bois	1
director	yvonne brewster	2
director	yves robert	1
director	yvonne rainer	1
novel	yvonne vera's stone virgins	1
politician	yvette clarke	1
popular brand	yves saint laurent	1
commentator	yvonne gallagher	1
notable	yves edwards	3
outlet	yves saint laurent	1
candidate	yves mersch	1
analyst	yvonne genovese	1
analyst	yves siegel at wachovia	1
famous name	yves rocher	1
famous name	yves saint laurent	1
resident	yvonne printup	1
painter	yves klein	1
conductor	yvan fischer	1
house	yves saint laurent	1
airport	yvr	2
campaign	yves saint laurent	1
famous artist	yves klein	2
famous artist	yves montand	1
supporter	yvo de boer	1
youngster	yven moyo	1
famous brand	yves saint laurent	1
practitioner	yvonne rainer	1
practitioner	yvette eastman	1
practitioner	yvonne todd	1
well-known brand	yves saint laurent	1
well-known brand	yves saint-laurent	1
choreographer	yvette lee	1
choreographer	yvonne rainer	1
actress	yvonne	1
actress	yvonne mitchell	1
international brand	yves st. laurent	1
filmmaker	yvonne rainer	1
parent	yvette	1
foundation	yves saint laurent perfect touch radiant brush foundation	1
newcomer	yvette alonso	1
guide	yves lagesse of chamex	1
merchant	yvonne fondi	1
contemporary artist	yvonne jacquette	1
big brand	yves saint laurent	1
description	yvonne ridley's	1
popular destination	yvr	1
infrastructure project	yvr renovation	1
industry group	yv fruits group	1
gem	yvonne printemps	1
top name	yves st laurent	1
top name	yves edwards	1
merchant page	yves-roche.com uk	1
merchant page	yvesrocher.com uk	1
merchant page	yves roches uk	1
theologian	yves congar	5
theologian	yves conger	1
consumer	yvonne squires	2
consumer	yvonne lim	1
consumer	yvonne martinez	1
gallery	yvonne kings studio	1
minister	yvette cooper	2
bloggers	yves	1
bloggers	yves smith at naked capitalism	1
bloggers	yves smith	1
jazz great	yvette glover	1
designer brand	yves saint laurent	2
designer brand	yves st. laurent	1
exhibition	yves st-laurent	1
prominent figure	yvonne dolan	1
consultant	yvette zgonc	1
staff member	yvonne greene	2
novelist	yvonne roberts	1
formula	yves saint laurent volume effet faux cils mascara	2
dancer	yvonne rainer	2
top designer	yves saint laurent	9
top designer	yves saint lauren	1
top designer	yves st. laurent	1
feminist	yvonne	1
luxury brand	yves saint laurent	6
luxury brand	yves st. laurent	1
movie star	yvonne de carlo	1
world leader	yvo de boer	1
fashion designer	yves saint laurent	6
fashion designer	yves saint-laurent	1
vocalist	yve evans	1
translation	yves congar's lay people in the church	1
commercial project	yves roche cosmetics store	1
secondary character	yves	1
boutique	yves saint laurent	1
crystal	yvo.sub. four  laser 	3
crystal	yvo four  laser 	1
lady	yvonne de carlo	1
brand name product	yves rocher	1
designer label	yves de laurent	1
board member	yves tomme	1
established brand	yves saint-laurent	1
famous company	yves saint laurent	2
kid	yvonne	1
attendee	yvone force villareal	1
codecs	yv twelve 	1
renowned brand	yves saint laurent	1
established name	yves saint lauren	1
established name	yves saint laurent	1
top quality brand	yves saint-laurent	1
high-profile client	yves saint laurent	1
social scientist	yves guyot	1
designer name	yves saint laurent	1
famous designer	yves st. laurent	1
famous designer	yves st laurent	1
fashion house	yves saint laurent	12
fashion house	yves st. laurent	2
top quality product	yves saint laurent	1
catalog	yvert & tellier	1
security threat	yves montand	1
visual artist	yves tanguy	1
visual artist	yvonne rainer	1
high-quality product	yves saint laurent	1
boot	yves saint laurent boot	1
fashion icon	yves st. laurent	1
top rider	yvonne barteau	1
biologist	yves basset	1
bestseller	yves saint laurent paris	1
bestseller	yves saint laurent yveress	1
regional player	yves rocher	1
well-known character	yvain	1
international designer	yves saint laurent	1
british artist	yve lomax	1
fashion label	yves st laurent	1
local resident	yvan besner	1
notable fighter	yves edwards	1
great designer	yves st. laurent	1
pupil	yvonne in mind	1
key leader	yvonne pearson	1
research university	yvy league research university	1
top designer brand	yves saint laurent	3
top producer	yves cuilleron	1
co-stars	yves montand	1
world class company	yves rocher	1
beautiful woman	yvonne nelson	1
voice actor	yvonne strahovski	1
high-end designer	yves saint laurent	1
european artist	yves klein	1
UFC fighter	yves edwards	1
established writer	yvonne brissett	2
international label	yves saint laurent	1
cosmetic company	yves saint laurent	1
art historian	yve-alain bois	1
contemporary musician	yves robert	1
top professional	yvette glover	1
top fashion designer	yves	3
designer shop	yves saint laurent	1
burger	yves	1
popular designer	yves saint laurent	1
designer boutique	yves saint-laurent	1
avant-garde artist	yves klein	1
company	yves saint laurent	3
established designer	yves saint laurent	1
luxury store	yves saint laurent	1
upscale retailer	yves saint laurent	1
upscale retailer	yves saint-laurent	1
young writer	yvonne foong	2
food brand	yves	1
private individual	yvonne de mello	1
famous fashion designer	yves st. laurent	1
prominent woman	yvette cooper	1
modern poet	yvor winters	1
company	yvert & tellier from france	1
company	yves rocher	1
company	yves st laurent	1
company	yves st. laurent	1
company	yves	1
refugee	yvette	1
talented designer	yves saint laurent	1
high end company	yves saint laurent	1
famous dancer	yvette guilbert	1
guest DJs	yves eaux	1
renowned singer	yves montand	1
couturier	yves saint laurent	2
couturier	yves st. laurent	1
descendant	yvonne bivins	1
historic name	yves saint laurent	1
classic designer	yves saint laurent	1
famous international brand	yves saint laurent	1
jazzmen	yves robert	2
australian act	yves klein blue	1
perfume brand	yves st laurent	1
french brand	yves saint laurent	1
notable leader	yvonne kalench	1
pedagogue	yvonne hubert	1
political opponent	yves montand	1
video artist	yvonne rainer	1
brights	yves klein blue	2
surrealist	yves tanguy	3
high end shop	yves saint lauren	2
Printmakers	yvonne boag	1
small-business owner	yvonne hardin	1
catholic theologian	yves congar	4
home store	yves delorme	1
equestrian artist	yvonne anne located in devon	1
famous fashion house	yves saint laurent	1
faithful	yvonne	1
Young turks	yvan mispelaere at louis feraud	1
couture house	yves st-laurent	1
educationalists	yvonne craig	1
established producer	yves eaux	1
fashion great	yves saint laurent	1
fashion great	yves saint-laurent	1
feminist artist	yvonne rainer	1
surrealist artist	yves tanguy	1
top fashion house	yves saint laurent	1
concealer	yves saint laurent touche eclat work wonders in reducing under-eye darkness	1
decorator	yves st laurent	1
independent journalist	yvonne di vito	1
world-famous name	yves saint laurent	1
big-name designer	yves saint laurent	1
demonstrator	yvonne campbell	1
fashion giant	yves saint laurent	2
high-end fashion designer	yves saint laurent	1
international famous brand	yves saintlaurent	1
prestigious line	yves saint laurent	1
branded sunglasses	yves saint laurent	1
expressionist	yvan goll	1
luxury name	yves saint laurent	1
solid-state laser	yvo.sub. four  laser 	1
young starlet	yvonne lim	1
today designer	yves saint laurent	1
top international company	yves st laurent	1
fashion powerhouse	yves saint laurent	2
big fashion house	yves saint laurent	1
hockey legend	yvon lambert	1
luxury designer	yves saint laurent	1
visionary artist	yves klein	1
global luxury brand	yves saint laurent	1
ionic material	yvo four 	1
international fashion house	yves st. laurent	1
top design house	yves saint laurent	1
high profile campaign	yves saint laurent	1
intimate	yvor winters	1
excimer laser	yvo  four  laser 	1
excimer laser	yvo . sub . four  laser 	1
fashion luminary	yves saint laurent	1
luxury shop	yves saint laurent	1
fake meat	yves sausage	1
SS	yvonne godfrey	1
ambitious work	yvain	4
famous luxury brand	yves saint laurent	1
famous sailor	yves parlier	1
semifinalist	yvonne vermaak	1
status brand	yves st. laurent	1
cowboy poet	yvonne hollenbeck	1
elite designer	yves saint laurent	1
famous designers fashion shop	yves saint laurent	1
global consumer brand	yves st laurent	1
high-end, luxury brand	yves st laurent	1
luxury designer label	yves saint laurent	2
surrealist painter	yves tanguy	1
TV producer	yvette lee bowser	1
youth member	yvonne lopez	1
contest winner	yves christian fournier	1
end designer	yves saint laurent	1
famous brand advertising campaign	yves saint-laurent	1
french film star	yves montand	1
french label	yves saint laurent	1
french singer	yves montand	1
literary agent	yvonne kinsella	4
party heavyweight	yvette cooper	1
sex worker	yvette	1
famous designer house	yves saint-laurent	1
famous knight	yvain	2
popular international brand	yves saint laurent	1
web developer	yves saint laurent	1
world designer	yves saint laurent	1
world's fashion geniuses	yves saint laurent	1
alpine resort	yvoire	1
big schlager name	yves segers	1
famous fashion brand	yves saint laurent	1
famous french artist	yves montand	1
local and international DJs	yves larock	1
notable theologian	yves congar	1
top fashion disigners boutique	yves st. laurent	2
vintage designer handbag	yves st. laurent	1
well-known quilt artist	yvonne porcella	1
action heroine	yvonne strahovski	1
ceramic laser	yvo four  laser 	2
ceramic laser	yvo.sub. four  laser 	1
designer pair	yves saint laurent	1
disability advocate	yvonne peters	1
disabled child	yvonne	1
first-rate building contractor	yves st laurent	1
french luxury brand	yves saint laurent	1
great montreal canadian player	yvan cournoyer	1
historical brand	yves saint laurent	1
program	yvc in experiential term	1
prominent art historian	yve-alain bois of the school of historical studies at the institute for advanced stuy in princeton	1
prominent art historian	yves-alain bois from princeton university	1
prominent art historian	yve-alain bois from princeton university	1
sharpshooter	yvan cournoyer	1
signature name	yves saint laurent	1
world-famous department store	yves saint laurent	1
young lady	yvonne daley	1
apartment block	yve apartments	1
catholic liberal theologian	yves congar	1
celebrated fashion designer	yves st. laurent	1
designer god	yves saint laurent	1
famous guest star	yvonne de carlo	1
founding player	yvette holt	1
french heavyweight	yves simon	1
good decorator	yves e laurent	1
high-end cosmetic line	yves saint laurent	1
iconic french brand	yves saint laurent	1
luxury fashion house	yves saint laurent	1
Notable printmakers	yvonne boag	1
smart retailer	yves saint laurent	1
stamp catalog	yvert et tellier	1
stamp catalog	yvert	1
top fashion designers boutique	yves st. laurent	2
trend designer label	yves saint laurent	1
tuxedo	yves saint laurent	1
unusual make	yves cogan	1
well-known fragrance	yves saint-laurent	1
african novel	yvonne vera's nehanda	1
clothing mogul	yves	1
cult designers store	yves saint laurent	1
exceptional building contractor	yves st laurent	1
famous czech musician	yvonne sanchez	1
france such beautiful place	yvoire	1
high end mascara	yves st. laurent faux cils	1
iconic New Zealanders	yvette williams	1
popular western beauty brand	yves saint-laurent	1
preeminent qualitative researcher	yvonna lincoln	1
reputable fashion house	yves saint laurent	1
sheer fashion	yves saint laurent	1
stylish cosmetic brand	yves saint laurent	1
world-renowned luxury brand	yves saint laurent	1
acceptable engineer	yves e laurent	1
beloved pricey label	yves saint laurent	2
celebrated fashion house	yves saint-laurent	1
contemporary acadian artist	yvon gallant	2
design luminary	yves st. laurent	1
fiction title	yvonne vera's opening spaces anthology	1
french fashion design house	yves saint laurent	1
globe's top designer brand	yves delorme	1
high-class boutique	yves saint laurent	1
ice climbing pioneer	yvon chouinard	1
marvelous creator	yves saint laurent	1
ministerial ally	yvette cooper	1
old-time french cabaret artist	yves montand	1
optic crystal	yvo four 	1
progressive voice	yvonne fernandes	1
Prominent self-identified homosexual Christians	yvette flunder	1
renowned theologian	yves congar	1
sale manager	yves d'halluin	1
stella's a-list attendee	yves saint laurent s creative director	1
stella's a-list attendee	yves saint laurent's creative director	1
strong lady	yvonne strahovski	1
Swiss film-makers	yves yersin	2
top end designer	yves saint laurent	1
toxicologist	yves allarie of pittsburgh university	1
young speedy shock troop	yvon lambert	1
ACF leader	yvette sanchez fuentes	1
airport code	yvr	1
art industry insider	yvonne force villareal	1
black nationalist writer	yvette abrahams	1
Charlottesvile personal injury attorney	yvonne griffin	1
constant fan	yvetta graff	1
copied brand name product	yves st laurent	1
dirtbag pioneer	yvon chouinard	1
element value	yvalue	3
exclusive designers name	yves st. laurent	1
french famous artist	yves montand	1
german top act	yvonne catterfeld	1
global speaker	yvonne buischi	1
great fashion luminary	yves st. laurent	2
interesting catch	yvto venezuela	1
international big house	yves saint laurent	1
international fashion icon	yves st. laurent	1
italian sausage	yves veggie spicy italian sausage	1
Judsonites	yvonne rainer	1
latin brand	yves st laurent	1
Longtime MPs	yvon godin	1
old-guard politician	yvon neptune	1
prominent and high-end retailer	yves saint laurent	1
smart designer boutique	yves saint laurent	1
stylish replica handbag	yves saint laurent handbags	1
successful international show	yvon of the yukon	1
top figure skater	yvonne gomes	2
twentieth century french author	yvan lagesse	1
typical parisian musician	yves montant	1
well-established fashion house	yves saint laurent	1
world-renowned climber	yvon chouinard	1
young rock climber	yvon chouinard	1
area showcase label	yves saint laurent	1
award-winning novelist	yvonne vera	1
big ministerial hitter	yvette cooper	1
big name campaign	yves saint-laurent	1
name	yves saint laurent	4
name	yves st. laurent	4
name	yves saint lauren	3
concrete local initiative	yves rocher foundation's women of the earth contest	1
cosmetic couture brand	yves saint laurent	1
couture name	yves saint laurent	1
culturally important town	yvoire	1
designers brand	yves saint laurent	1
dress-poured guest	yvonne force villareal	1
eastward-bound dance pilgrim	yvonne rainer	1
environmental bigwig	yvo de boer	1
environmental big-wigs	yvo de boer	1
excellent birefringent crystal	yvo four 	1
experienced drummer	yvonne chiang	1
famed knight	yvain	1
famous shoe sale online	yves saint laurent	1
name	yves st laurent	1
name	yves-gerard illouz	1
name	yvonne	1
name	yvonne de carlo making a cameo appearance	1
fashion mastermind	yves saint laurent	1
fashionfashionfashion house	yves st. laurent	1
first GIF animation program	yves piguet's gifbuilder	1
Flagmakers	yves telemak	1
geometric abstractionists	yves gaucher	1
graduate-level textbook	yvonne rogers	1
great monochrome painter	yves klein	1
greatest fashion designer	yves saint-laurent	1
greatest NHL star	yvan cournoyer	1
high quality fiber crystal	yvo four 	1
historical dance work	yvonne rainer's chair pillow dance'' from continuous project altered daily	1
Hollywood's helmeted heroes	yves montand in grand prix	1
iconic male artist	yves klein	1
innovative fashion house	yves saint laurent	2
Iraqi Jews	yvette dabby	1
local music star	yvonne chaka-chaka	1
lovely monument	yvoire castle	1
luxury cosmetic	yves saint laurent lipstick	1
modem theologian	yves congar	1
once-dominant fighter	yves edwards	1
one-of-a-kind find	yvonne la fleur	1
pink scarf accessory	yves saint laurent wool	1
poet-critics	yvor winters	2
case	yvo four 	1
qualitative evaluation specialist	yvonna lincoln	1
renowned french performer	yves montand	1
sangha member	yvette	1
senior UK figure	yvette cooper	1
sleek, chic style	yves st. laurent's pantsuit	1
strong designer label	yves saint laurent	1
sustainability champion	yvon chouinard at patagonia	1
top french designer	yves st.laurent	1
world big player	yves rocher	1
zimbabwean literary celebrity	yvonne vera	1
big black thickening mascara	yves saint laurent volume mascara	1
brazilian intermediary	yvonne	1
classy chick	yvette	1
commencement ceremony	yvonne herrington	1
commercial designer	yves saint lauren	1
compay	yves	1
deparmental archive	yvelines	1
designing mastermind	yves saint laurent	1
fascinators	yvette	1
global industry heavy-weights	yves bernard	1
haitian flag	yves telemaque's erzulie freda	2
irrational Yelpers	yvonne	1
knowledgeable financial commentator	yves smith	1
Licensed hypnotherapists	yvonne smith	1
niche perfumer	yves rocher	1
notable partner organization	yves saint laurent	2
pictorial reference	yves klein's anthropometries	1
prodigious talent	yves behar	1
red book name	yves hurry	1
sheer, nude lipstick	yves saint laurent's rouge personnel	1
successful regional theater	yvonne arnaud theatre in guildford	1
year distinguished author	yves congar	1
project	yvr airport upgrade	2
project	yvr airport project	1
artist	yves klein	16
artist	yvonne rainer	3
artist	yvonne koolmatrie	2
artist	yves amu klein	2
artist	yvonne jacquette	2
artist	yvonne	1
artist	yvonne kenny	1
artist	yvonne mansfield	1
artist	yvy queen	1
artist	yvette neumann	1
artist	yvonne audette	1
artist	yves kline	1
artist	yves netzhammer	1
artist	yves banchelin	1
artist	yves dechary	1
artist	yvonne jobin	1
artist	yves tanguy	1
artist	yves thomas	1
artist	yves klein in france	1
artist	yves robert	1
artist	yvonne roudette	1
brand	yves saint laurent	37
brand	yves rocher	3
brand	yves sain laurent	3
brand	yves delorme	2
brand	yves saint lauren	2
brand	yves saint-laurent	1
brand	yvonne black	1
brand	yves sant laurent	1
brand	yves st. laurent	1
