ophthalmologist	z. nicholas zakov	1
document	z. w. wicks jr.	1
solution	z.b. with break framework	1
plant	z. may	2
city	z. b. cape may	1
equipment	z. b. leather seat	1
country	z. b. austria	1
country	z. b. iran	1
language	z. many western european language	1
tree	z. b. beech	1
organism	z. bailii	4
personality	z. b. heinrich heine	1
politician	z. a. bhutto	1
enterprise	z. b the oil	1
worker	z. weissman	1
conductor	z. mehta	2
department store	z.c.m.i. in salt lake city	1
colony	z. b. india	1
businessman	z. deline	1
structural measure	z. b. facade repair	1
private foundation	z. smith reynolds foundation	1
contemporary composer	z. randall stroope	1
yeast	z. bailii	4
Protestants	z. hodges	1
large machine	z. b. wheeled loader	1
monocots	z. may	1
european language	z. many western european language	1
alphabet	z. sub . zero 	1
visual difference	z.e. badge	1
western european language	z. many western european language	1
western figure	z. brzezinski	1
israeli scholar	z. rabinowitz	1
inorganic metal oxide	z. sub . nfe . sub . two  o. sub . four 	1
organization	z. smith reynolds foundation	1
christmas PS2 game	z.o.e.	1
distinct boutique	z. bead	1
Stenophagous species	z. eupheme	1
treason trialists	z. k. matthews	1
halluzinogene substance	z. b. lsd	1
quadratic gradient field	z.sup. two  gradient field 	1
stillsome lock	z. b. in mannheim	1
striking change	z. for zinhle	1
buddhistische myth	z. b. over the bodhisattva guanyin	1
cross-beam larger local load	z. b. by stony structure place	1
dif-ferentspecies	z. bailii	1
DVD edition	z. b. the cinemathek of the south german newspaper	1
innovative funding initiative	z.a.p tax	1
Metallchloride	z. b. sodium	1
play possibility	z. b. reckless driving	1
private-sector supporter	z. smith reynolds foundation	1
section individual board	z.b. the board for the audio analog section	1
thing outstanding expert	z. b. the later telegrafentechniker johann george halske trained	1
tradesmen's settlement	z. b. large printering	1
VeriSilicon's software solution	z.voice for voip application	1
year foundation	z. smith reynolds	1
artist	z. mehta	1
material	z. b. water	1
term	z. b. displacement	1
species	z. bailii	1
