product	zbook	1
book	zbigniew brzezinski's the secrets of shah's fall	1
scholar	zbiegniew brzezinski	1
man	zbignew brezinsky	1
figure	zbigniew brzezinski	2
musician	zbigniew namyslowski	1
store	zbloomindales	1
package	zbrush	1
apps	zbrush	1
forum	zbrush central	1
poet	zbigniew herbert	1
key player	zbynek michalek	2
financial institution	zb bank	2
public place	zbb	1
item	zbf	1
prominent figure	zbigniew brzezinski	1
formulation	zbb	1
call	zbigniew brzezinski's for an expanded nato	1
big corporation	zb bank	1
buffer	zbuffer	1
social scientist	zbigniew brzezinski	1
adviser	zbigniew brzezinski	1
commercial tool	zbrush	1
american author	zbigniew brzezinski	1
political scientist	zbigniew brzezinski	1
toolkits	zbot	2
management process	zbb	1
parastatals	zbc	1
modern composer	zbigniew preisner	1
maestro	zbigniew preisner	1
controversial figure	zbigniew brzezinski	1
company	zbb energy corp	3
influential thinker	zbigniew brzezinski	1
drawing program	zbrush	1
fraternity	zbt	1
company	zbb energy	1
notable person	zbigniew brzezinski	2
3D program	zbrush	1
large station	zbaszynek	1
prominent political figure	zbigniew brzezinski	2
policy expert	zbigniew brzezinski	1
high-speed interface	zbt memory	2
RNA binding protein	zbp one 	2
public medium	zbc	1
operating brand	zb	1
program	zbrush	6
budgeting technique	zbb	2
influence minimalist and electronic composer	zbigniew preisner	1
influence minimalist and electronic composer	zbigniew	1
east european poet	zbigniew herbert	2
osteoporosis-associated gene	zbtb fourty 	1
best polish musician	zbigniew wegehaupt	1
best polish musician	zbigniew namyslowski	1
classical geopolitical theorist	zbigniew brzezinksi	1
quantitative system	zbb	1
serbian organization	zbor	4
strong national security adviser	zbigniew brzezinski	1
volunteer official	zba	1
world-renowned strategist	zbigniew brezinski	1
advanced modeling program	zbrush	1
american strategic thinker	zbigniew brzezinski	1
art forum	zbrush central	1
technique	zbb	2
technique	zbrush modeling	1
conservative catholic layperson	zbigniew brzezinski	1
exemplary lackey-like figure	zbigniew brzezinski	1
Knowing 3D software	zbrush	1
application	zbrush	5
3D program application	zbrush	1
american battery company	zbb energy	2
budget brass cymbal	zbt	1
budgeting approach	zbb	1
famous solidarity activist	zbigniew romaszewski	1
fluoride glass	zblan	1
high end package	zbrush	1
NPM-reforms	zbos in the netherlands	1
policy thinker	zbigniew brzezinski	1
prominent internationalist	zbigniev brzezinski	1
3-D modeling application	zbrush	1
3D paint program	zbrush	2
american imperialist	zbigniew brzezinski	1
cold-warriors	zbig brzezinski et al.	1
Copeland compressor ZR47KC-TFD-522	zb	1
defensive forebear	zbikowski	1
difference betweenaquasi judicial neutral board	zboa versus the pb	1
Flow battery startups	zbb energy	1
fluoride-based fiber	zblan fiber	1
fluorozirconate fiber	zblan	2
good sculpture program	zbrush	1
heavy-metal fluoride fiber	zblan with low phonon energy	1
infrared glass	zblan	1
modern modeling program	zbrush	1
notorious banking trojans	zbot	2
rock specific set	zbt rock set	1
sculpting software	zbrush	1
universal repulsive potential	zbl parameterizations	5
tool	zbrush	4
zildjian cymbal	zbt	1
artist	zbigniew gostomski	1
artist	zbigniew karkowski	1
material	zblan	1
place	zbw	1
player	zbikowski	1
player	zbynek hracek	1
system	zbb	1
