product	zf one hundred and fourty-four thousand seven hundred and eight  toy guns 	1
product	zf toy guns	1
product	zfone	1
feature	zfs	3
idea	zfs	1
manufacturer	zf sachs ag	1
manufacturer	zf	1
feature	zfs functionality	1
instance	zf	1
big name	zf	1
advanced feature	zfs file system	1
customer	zf's german customer	1
customer	zf lemforder	1
capability	zfs	3
competitor	zf friedrichshafen ag	1
functionality	zfs	1
theory	zfc	1
theory	zfa	1
supplier	zf gb	1
supplier	zf	1
domain	zfdhhc & chaperon	1
account	zfs account	1
standard feature	zf recirculating power assisted ball steering wheel	1
issue	zfs pool awareness	1
gene	zfp one hundred and sixty-one 	2
goodie	zf  eight -speed automatic transmission 	1
international company	zf friedrichshafen	1
well-known company	zf	1
powerful feature	zfs	1
global player	zf	1
global organization	zf	2
european company	zf	2
file system	zfs	7
good point	zfs being	1
jewish organization	zf	1
topic	zfs file system	1
technology advancement	zfs boot	1
company	zf friedrichshafen ag	3
company	zf	3
company	zf marine	1
filesystems	zfs	2
specialty company	zfx	1
filesystem	zfs	1
public product	zfp	1
global auto component giant	zf	3
DCT market european company	zf	1
auto ancillary company	zf steering	1
german customer	zf's german customer	1
MIMO system	zf system	2
tranny	zf  five -spd. 	1
automotive part giant	zf	1
leading automotive component company	zf steering	1
POSIX compliant disk file system	zfs	1
power technology manufacturer	zf passau	1
expert topic	zf production system	1
linear detection technique	zf	1
linear detection technique	zf filtering	1
linear receiver	zf	1
application	zf	1
relay method	zf-p-qr method	1
separate detection technique	zf	2
solaris-exclusive feature	zfs	1
strong global player	zf	1
advanced filesystems	zfs	1
five-speed manual	zf s five - fourty-two 	1
five-speed manual	zf s five - fourty-seven 	1
open-source-based storage tool	zfs for file system	1
OS level snapshot solution	zfs for solaris	1
pooled storage system	zfs	1
solaris feature	zfs	2
transmission manufacturer	zf	1
acth-responsive cell	zf cell	1
cell-engineering method	zfn-mediated knockout	1
classical linear detection structure	zf	1
computationally efficient suboptimal detector	zf detector	1
conventional set theory	zf	1
country's best supplier	zf	1
COW filesystem	zfs	1
edf-binding protein	zfsta two  polypeptides 	1
flying company	zfx	1
Iveco power steering box	zf	1
large scale gearbox manufacturer	zf	1
latest automated-shift mechanical gearshift system	zf system in the iveco daily agile	1
leveraging key opensolaris feature	zfs	1
material set theory	zf	1
Modern axiomatic set theory	zf	3
monosubstituted Z	zf for illustration	1
non-hazard product	zfp	1
practical user-aided key agreement protocol	zfone protocol	1
qrdandsic detection conventional receiver	zf	1
renault gearbox	zf s five . fourty-two 	1
smart file system	zfs	1
snapshot solution	zfs snapshots after using flush tables with read lock	1
solaris technology	zfs	1
transmission supplier	zf	1
unclassified zinc finger protein	zfp thirty-six 	1
urban and regional plannrng method	zfte growth cenler slraleg	1
Volvo power steering box	zf	1
technology	zfs	3
brand	zf	1
