datum	zygosity	1
game	zynga's farmville	7
game	zynga s farmville	2
game	zynga poker	2
game	zynga's empires & allies	1
game	zynga s mafia wars	1
game	zynga's farmville on facebook	1
game	zynga's other game	1
game	zynaps	1
subject	zydeco	1
work	zygotic acceleration	1
word	zygotene	1
client	zynga	1
author	zygmunt bauman	4
product	zymox with cortisone	1
form	zygonyx	1
alternative	zynga	1
writer	zygmunt bauman	4
structure	zygomatic arch	1
structure	zygospores	1
business	zynga	2
procedure	zygote intrafallopian transfer	1
band	zyklon	9
title	zynga poker	1
ingredient	zymomonas ferment extract	1
ingredient	zymol's special ingredient	1
agent	zyrtec	2
agent	zymosan	1
agent	zyprexa	1
scholar	zygmunt bauman	2
feature	zynoh ip feature	1
scholar	zygmunt abrahamowicz	1
development	zynga	1
disease	zygomycosis	2
venue	zydeco downtown in raleigh	1
firm	zynga	5
drug	zyprexa	29
drug	zyban	12
drug	zyrtec	11
drug	zyprexa for schizophrenia	2
drug	zyvox	1
drug	zyban for smoking	1
treatment	zyban	2
treatment	zygomatic implant	1
manufacturer	zyxel	2
musician	zydeco king clifton chenier	1
style	zydeco	1
medication	zyban	31
medication	zyrtec	13
medication	zyprexa	12
medication	zyloprim	2
medication	zyprexa aid in reducing symptom	1
medication	zyflo cr	1
Organisations	zytek	1
vendor	zynx	1
vendor	zygmunt	1
critic	zygmunt bauman	2
restaurant	zyng asian grill	1
chemical	zymosan	1
student	zylah rogers	1
trait	zygomatic arch	1
protein	zyxin	1
competitor	zynga	2
brand name	zyrtec	1
corporation	zygo	3
variation	zylinder	1
difference	zygomatic bone structure	1
package	zypper	2
medicine	zyrtec	4
medicine	zyban	2
medicine	zyprexa	2
medicine	zyvoxid	1
medicine	zyloprim	1
tree	zygophyllum dumosum	1
everything	zydeco	1
molecule	zymosan	1
organism	zymomonas mobilis	1
organism	zygomycetes	1
apps	zynga's popular farmville game	1
theorist	zygmunt bauman	3
stock	zywiec	2
supplement	zymase	1
rival	zynga	3
web site	zynga	2
genre	zydeco	3
aid	zyban	4
thinker	zygmunt bauman	2
giant	zynga	1
family	zygophyllaceae	1
enzyme	zypan from standard process	3
enzyme	zymogens	1
enzyme	zymase in yeast	1
developer	zynga	7
developer	zygi wilf	1
stimulus	zymosan	1
album	zygote poet	1
pathogen	zymosan-bearing fungus	1
combination	zyrtec-d	1
pest	zygogramma biccdorata	1
treatment option	zyprexa	1
item	zyrtec	1
dance	zydeco	3
big player	zynga	3
tree species	zygia cataractae	2
microorganism	zymomonas mobilis	3
microorganism	zygomycete fungus cunninghamella	1
stage	zygote	1
toxin	zymosan	1
guide	zygor's leveling guide	1
guide	zygor's dailies & events guide	1
strength	zyderm i	1
beer	zywiec	1
fungus	zygomycetes	2
fungus	zygomycete gigaspora sp.	1
fungus	zygomycosis	1
fungus	zygomycota	1
fungus	zygomycetes rhizopus	1
big event	zythos america	2
plastic	zytel	2
bacterium	zymomonas mobilis	2
prescription drug	zyban	7
prescription drug	zyprexa	2
prescription drug	zyrtec	2
studio	zynga	2
invasive procedure	zygote intrafallopian transfer	1
structural feature	zygomatic arch	1
prescription medication	zyban	9
prescription medication	zyloprim	2
stimulant	zymosan	1
natural substance	zymosan	1
popular game	zynga poker	7
star player	zydrunas ilgauskus	1
medical treatment	zyban	2
meds	zyprexa	3
heavy hitter	zynga	1
villain	zygons	1
musical influence	zydeco	1
assay	zymography	1
muscle	zygomatic muscles around the eye	1
pill	zyban	9
teammate	zydrunas ilgauskas	1
complex carbohydrate	zymogen	2
strain	zygosaccharomyces rouxii	2
indian company	zydus cadila healthcare	1
over-the-counter medication	zyrtec	2
popular model	zyliss easy spinner	1
startups	zynga	3
pharmaceutical company	zydus cadila	1
over-the-counter product	zyrtec	2
holding	zydus wellness	1
oral medication	zyban	1
oral medication	zyrtec	1
oral medication	zyprexa	1
sociologist	zygmunt baumann	1
potential confounders	zygosity	2
area	zynga	1
antidepressant	zyban	6
renowned company	zydus cadila	1
complex case	zygomatic implant	1
successful program	zydus talent management program	1
large business	zynga	1
role player	zydrunas ilgauskas	1
composite material	zyvex's nano-enhanced carbon fiber arovex	2
successful company	zynga	1
area	zygomatic arch	1
conventional treatment	zyrtec-d	1
antihistamine	zyrtec	90
antihistamine	zytec  ten mg in the am 	1
antihistamine	zyrtec-d	1
start-ups	zynga	1
allergy	zyrtec	1
modern method	zymogram technique	1
herbal medicine	zymo-zyme syrup	1
pharmaceutical product	zyban	2
rare condition	zyrtec syrup once rare condition	1
rare disease	zygomycosis	4
internet company	zynga	10
internet company	zynga inc.	1
counter medication	zyrtec	1
big name company	zynga	1
over-the-counter drug	zyrtec	2
over-the-counter drug	zyban	1
musical style	zydeco	2
fungal infection	zygomycosis	2
bacterial species	zymomonas mobilis	1
prescribed medication	zyban	1
large customer	zynga	1
over-the-counter medicine	zyrtec	1
tech company	zynga	5
drug therapy	zyban	1
orchid	zygopetalum	2
common medication	zyprexa	2
prescription medicine	zyban	1
marquee name	zynga	1
original equipment manufacturer	zykronix corporation	1
popular brand name	zyrtec	1
famous brand name	zyrtec	1
music style	zydeco	1
yeast	zygosaccharomyces spp	2
yeast	zygosaccharomyces	1
popular company	zynga	3
anatomical feature	zygodactyl foot	1
anatomical feature	zygodactyls foot	1
sub-genres	zydeco	1
spider	zygiella x-notata	1
common chemical	zyklon b	1
popular restaurant	zythos	1
acute disease	zymotic fever	1
antipsychotics	zyprexa	17
surgical method	zygomatic implants	1
high-profile player	zynga game network inc.	1
antidepressant medication	zyban	1
systemic medication	zyrtec	1
antidepressant drug	zyban	1
fungal pathogen	zygomycesand cryptococcus neoformans	1
fungal pathogen	zygomycetes	1
big man	zydrunas illgauskus	1
antipsychotic drug	zyprexa	9
semiconductor company	zygo	1
treatment procedure	zygote-intra fallopian tube transfer	1
scientific term	zygote	1
game developer	zynga	5
game developer	zynga game network	1
counter medicine	zyrtec	1
internet website	zynga	1
counter drug	zyrtec	1
anti-depressants	zyban	5
non-prescription drug	zyrtec	1
dangerous drug	zyprexa	2
inflammatory stimulus	zymosan	2
psychotropic medication	zyprexa	2
fracture	zygomatic	1
cultural theorist	zygmunt bauman	1
mood stabilizer	zyprexa	4
nerve	zygomatic	1
filamentous fungus	zygomycetes	1
Incases	zymogens	1
popular drug	zyprexa	1
Riparian species	zygophyllum morgsana	1
Riparian species	zygophyllum morysana	1
social networking application	zynga's farmville game	1
antipsychotic medication	zyprexa	17
company	zynga	86
company	zygo	3
company	zydus cadila	2
big developer	zynga inc.	3
huge brand	zynga	2
tranquilizer	zyprexa	2
web company	zynga	2
anatomic feature	zygodactyl foot	1
allergy medication	zyrtec	11
counter treatment	zymaderm for adult	1
dermal filler	zyplast	1
defensemen	zybnek michalek	1
internet giant	zynga	1
social website	zynga	1
expensive drug	zyprexa	1
popular medication	zyloprim	1
social dance	zydeco	1
tech stock	zynga	2
large pharmaceutical company	zydus cadila	1
oral antihistamine	zyrtec	19
prokaryotes	zymomonas mobilis	2
reproductive technology	zygote intrafallopian transfer	1
social game	zynga's farmville	1
social game	zynga	1
MAO inhibitor	zyvox	1
atypical antipsychotics	zyprexa	19
OTC medicine	zyrtec	1
company	zylab north america llc of mclean	1
company	zylog systems	1
company	zyomyx in hayward	1
company	zygo industries	1
company	zyxel communications	1
game publisher	zynga	2
pharmacotherapies	zyban	1
conventional medicine	zyrtac	1
Neuroleptics	zyprexa	2
nicotine replacement therapy	zyban	1
antipsychotic agent	zyprexa	1
OTC meds	zyrtec	1
assisted reproductive technology	zygote intrafallopian transfer	4
alien race	zygons	1
game company	zynga	1
leading pharmaceutical company	zydus cadila	1
neuroleptic drug	zyprexa	3
technical company	zynga	1
facebook application	zynga's farmville	1
prominent political figure	zyuganov	1
social thinker	zygmunt bauman	1
anti-histamines	zyrtec	2
neuroleptic medication	zyprexa	2
prescription pill	zyrtec	2
prescription pill	zyban	1
advanced design	zyoptix xp	1
over-the-counter antihistamine	zyrtec	14
phytopathogenic fungus	zygomycetes	7
psychotropic	zyprexa	1
smoking aid	zyban	2
allergy medicine	zyrtec	6
allergy medicine	zyrtec for long term relief	1
anatomical region	zygoma	1
antihistamine drug	zyrtec	1
epiphytic plant	zygocactus	2
game maker	zynga	1
gaming website	zylom	2
monitoring factor	zymolectin density	1
staffing firm	zylun staffing	1
antihistamine medication	zyrtec	7
antihistamine medication	zyrtec without success	1
fungal organism	zygomycetes	1
Sterols	zymosterol	3
inert particle	zymosan particle	1
litigation	zynga litigation against playdom	1
OTC antihistamine	zyrtec	5
OTC antihistamine	zyrtec before bed	1
second-generation antihistamine	zyrtec	2
today organization	zylog systems	1
large case	zyprexa mdl products liability lawsuit	1
popular online game	zynga poker	1
anti depressant	zyban	1
anti-psychotics	zyprexa	9
inflammatory molecule	zymosan	2
scaffold protein	zyxin	1
spinal procedure	zygapophysial joint intervention	2
big rival	zynga	1
non-sedating antihistamine	zyrtec	10
popular social medium site	zynga	2
anti-psychotic medication	zyprexa	4
internet property	zynga	1
atypical antipsychotic medication	zyprexa	1
high modulus fiber	zylon	1
prescription antihistamine	zyrtec	5
atypical antipsychotic drug	zyprexa	3
assisted reproductive technology procedure	zygote intrafallopian transfer	11
assisted reproductive technology procedure	zygote intra fallopian transfer	2
NFL owner	zygi wilf	1
nicotine replacement therapy product	zyban	1
christmas plant	zygos	1
generation antipsychotics	zyprexa	1
antipsychotic medicine	zyprexa	1
generation antihistamine	zyrtec	3
international visitor	zygmunt	1
internet titan	zynga	1
nonsedating antihistamine	zyrtec	1
polymer fiber	zylon	1
atypical anti-psychotics	zyprexa	5
Big drugmakers	zydus cadila	2
second generation antihistamine	zyrtec	3
specialty dance	zydeco	1
systemic antihistamine	zyrtec	1
nylon	zytel  one hundred and twenty-two l 	1
Second-generation antipsychotics	zyprexa	1
silicon valley firm	zynga	1
allergy pill	zyrtec	2
allergy relief product	zyrtec	1
atypicals	zyprexa	1
cessation aid	zyban	1
day-flying moth	zygaeninae burnet moth	1
popular poker game	zynga	1
second generation antipsychotics	zyprexa	1
slicer	zyliss slicer	1
zinc finger protein	zyxin	1
activating agent	zymosan-activated plasma	1
allergy meds	zyrtec	1
choice music genre	zydeco	2
counter allergy medication	zyrtec	1
counter antihistamine	zyrtec	1
event	zygotic transcription	1
franchise game	zynga poker	2
internet powerhouse	zynga	1
leukotriene modifier	zyflo	1
online gaming site	zynga	1
opportunistic fungal infection	zygomycosis	1
over-the-counter allergy medication	zyrtec	2
recommended medication	zyban	1
social medium company	zynga	1
anti-depressant or anxiety medication	zyban	1
antipsychotic or neuroleptic drug	zyprexa	2
digital currency	zynga coins	1
doubt company	zynga	1
mental health drug	zyprexa	1
national and transnational brand	zydus cadila	1
program	zyzzyva	1
non-animal, non-mammal organism	zygomycota fungus	1
outside developer	zynga	1
over-the-counter brand	zyrtec	1
social networking company	zynga	1
xenografts	zyplast	1
anti-allergy medication	zyrtec	3
atypical anti-psychotic medication	zyprexa	1
focal adhesion protein	zyxin	1
low-sedating antihistamine	zyrtec	4
musical entertainment	zydeco flames	1
non-drowsy antihistamine	zyrtec	1
non-nicotine medication	zyban	1
original costume	zygons	1
priming agent	zymosan	2
allergy drug	zyrtec	1
anti-histamine drug	zyrtec	1
common antihistamine	zyrtec	1
deep fungal infection	zygomycosis	1
domestic pharmaceutical company	zydus cadila	1
facial muscle	zygomaticus major	1
forward-looking scholar	zygmunt bauman	1
generation medication	zyprexa	1
high-profile internet company	zynga	1
high-tech fabric	zylon	1
jazz-related music style	zydeco	1
leukotriene receptor antagonist	zyflo	1
long-acting antihistamine	zyrtec	2
pfizer drug	zyrtec	1
phytopatliogenic fungus	zygomycetes	2
popular prescription medication	zyrtec	1
Technology startups	zynga	1
temporary filler	zyplast	1
all-in-one appliance	zyxel's  eight -in- one  utm solution for solid protection 	1
atypical psychotropic medication	zyprexa	2
generation atypical antipsychotics	zyprexa	1
indigenous american folk form	zydeco	1
non-sedating product	zyrtec	1
over-the-counter allergy medicine	zyrtec	3
popular zynga game	zynga poker	1
skull element	zygomatics	1
smoking cessation medication	zyban	1
so-called atypical antipsychotic drug	zyprexa	1
social medium major	zynga	2
Sometimes antipsychotics	zyprexa	1
spinoff business	zyvex instruments	1
spinoff business	zyvex performance materials	1
star city adventure ride	zyklon loop	1
substage substages	zygotene	1
Topical fluoroquinolones	zymar	1
well-known social medium website	zynga	1
zip file	zygote model	1
antimanic medication	zyprexa	1
big drug maker	zydus cadila	1
collagen filler	zyplast	2
consumer router	zyxel	1
cytoskeletal adaptor protein	zyxin	1
organization	zyx	1
global and indian pharmaceutical company	zydus cadila	1
Grievous antipsychotics	zyprexa	1
heavyweight studio	zynga	1
ip feature	zynoh ip feature	1
labor union leader	zygmunt wrzodak	1
latest generation product	zylon	1
leading indian drug maker	zydus cadila	1
leascholds	zyrwiny	1
nonprescription antihistamine	zyrtec	2
non-saccharomyces yeast	zygosaccharomyces	1
novel formulation	zydis	1
over-the-counter children's medicine	zyrtec	1
Polymorphic antipsychotics	zyprexa	2
organization	zynga	1
technique	zymography	3
potyviruses	zymv	1
Predictive antipsychotics	zyprexa	1
prescription non-sedating antihistamine	zyrtec	1
prescription oral antihistamine	zyrtec	2
special ingredient	zymol's special ingredient	1
spectacular and horticulturally important genus	zygopetalum	1
spoilage yeast	zygosaccharomyces bailii	2
spoilage yeast	zygosaccharomyces spp	1
Tragic antipsychotics	zyprexa	1
Unbranded antipsychotics	zyprexa	1
Unhurt antipsychotics	zyprexa	1
young reformer	zya kamali	1
abilify drug	zyprexa	1
acting antihistamine	zyrtec	1
advanced interference technique	zygo	1
allergy tablet	zyrtec	1
antihystamines	zyrtec	1
antipsychotics drug	zyprexa	1
archaic whale	zygorhiza kochii	1
artificial insemination technique	zygote intrafallopian transfer	1
brand-name antipsychotic drug	zyprexa	1
CAPI device	zyxel	1
casual game company	zynga	2
closely-watched company	zynga	1
controller asthma medication	zyflo	1
daily allergy medication	zyrtec	3
day allergy meds	zyrtec	1
delayed IPOs	zynga	1
effective antipsychotic medication	zyprexa	1
emerging fungal pathogen	zygomycetes	1
equally risky drug	zyprexa when antidepressants like paxil	1
famous polish mathematician	zygmunt janiszewski	1
flagship indian generic player	zydus cadila	1
technique	zygapophyseal joint block	1
gaming publisher	zynga	1
gold medalist	zygmunt smalcerz	1
home-grown superstar	zymogenetics	1
hot internet company	zynga	1
informative trait	zygote structure	1
molecular epidemiological analysis	zymovar analysis	1
monster IPOs	zynga	2
nondrowsy antihistamine	zyrtec	1
nonseptate filamentous fungus	zygomycetes	1
once-a-day antihistamine	zyrtec	2
once-daily antihistamine	zyrtec	1
OTC allergy eye drop	zyrtec eye	1
OTC allergy medication	zyrtec	1
OTC anti-allergy drug	zyrtec-d	1
OTC antihistamine medication	zyrtec	1
outsourcing laboratory service	zygosity testing & analysis	1
over-the-counter nonsedating oral antihistamine	zyrtec	2
popular antihistamine	zyrtec	1
potential bioagents	zygogramma bicolorata	1
prescription cessation medication	zyban	1
prescription strength antihistamine	zyrtec	1
restricted anatomical region	zygomatic	2
rodent tissue	zymbal's gland	1
second-generation oral antihistamine	zyrtec	1
smoking medicine	zyban	2
smoking pill	zyban	3
snazzy name	zyprexa	2
social gaming company	zynga	4
social-gaming company	zynga	1
taiwanese WLAN equipment maker	zyxel communications co	1
technical medical term	zygote	1
technology star	zynga	2
today's marquee name	zynga	1
unified threat management appliance	zyxel usg two hundred  zywall 	1
unified threat management appliance	zyxel usg fifty  zywall 	1
unified threat management appliance	zyxel usg one hundred  zywall 	1
wild-growing grassy plant	zygophyllum	1
addictive apps	zyngas farmville	1
addictive apps	zynga's farmville	1
antibiotic drop	zymar	1
Antihistimines	zyrtec	1
anti-psych drug	zyprexa	1
archaeocete cetacean	zygorhiza	1
authentic polish beer	zywiec	1
Biofillers	zyplast	1
Bipolar, atypical meds	zyprexa	1
bit mood modifier	zylke nincrease in road injury	1
brand beer	zywiec	2
application	zynga farmville	1
name	zyklon	1
comedy figure	zyuganov	1
counter allergy medicine	zyrtec	1
cranial character	zygomatic width	1
cricetidae	zygodontomys	1
daily allergy pill	zyrtec	1
detailed molecular epidemiological analysis	zymovar analysis	1
dissolvible tablet	zym	1
entsfor pharmaceutical smoking cessation aid	zyban	1
ethanologenic microorganism	zymomonas mobilis	3
ethanologenic organism	zymomonas mobilis	7
expensive antipsychotics	zyprexa	1
fast-growing social game firm	zynga	1
free game developer	zynga	1
free-to-play social game	zynga's farmville	1
gigaom with technology star	zynga	2
high quality modem	zyxel u- three hundred and thirty-six 	1
high-performance resin	zytel	1
high-strength polymeric fabric	zylon	1
hot start-ups	zynga	1
hour antihistamine	zyrtec	1
india's major player	zydus cadila	1
intra-uterine stage	zygote	1
large local player	zydus cadila	1
name	zyprexa	1
name	zyrtec	1
case	zyprexa	2
case	zynga	2
case	zyklon b	1
longer-acting, non-sedating, over-the-counter antihistamine medicine	zyrtec	1
louisiana style	zydeco	1
maternal and twin-specific factor	zygosity	1
memorable one-time villain	zygons	1
mild allergy medicine	zyrtec	1
miniature twig epiphytes	zygostates	1
newer-generation prescription antihistamine	zyrtec	1
nonconventional yeast	zygosaccharomyces rouxii	1
nonsedating antihistamine medication	zyrtec	1
non-sedating medicine	zyrtec	1
once-daily allergy pill	zyrtec	1
OTC allergy med	zyrtec	1
OTC anti-histamines	zyrtec	1
over-the-counter anti-allergy medication	zyrtec	1
over-the-counter non-drowsy antihistamine	zyrtec	2
over-the-counter nonsedating antihistamine	zyrtec	1
pasolini scholar	zygmunt baranski	1
phagocytic stimulus	zymosan	1
popular online guide	zygors guide	1
prescription smoking cessation medication	zyban	2
proboscideans	zygolophodon turicensis schinz	1
reliable tablet	zyrtec	1
Second-generation or atypical neuroleptics	zyprexa	1
skull fragment	zygomatic	1
small-sized player	zydus wellness	1
smoking cessation pill	zyban	1
smoking medication	zyban	1
so-called atypical antipsychotics	zyprexa	1
social gaming site	zynga	2
st. columba activity	zydeco dance	1
case	zymogens	1
tedco-supported business	zymetis inc. in college park	1
TOPKEN product	zy concrete expansion agent	1
traditional business brand	zyxel	1
uncommon fungus	zygomycetes	1
uric acid blocker	zyloprim	1
venture-funded company	zynga	1
well-known online game company	zynga	1
wildly successful company	zynga	1
ZYMV strain	zymv type strain from italy	1
Accompanying species	zygophyllum gaetulum	1
advanced external nanometrology equipment	zygo interferometers	1
anti allergy medicine	zyrtec	1
anti deppresion drug	zyprexa	2
anti-psychotic medicine	zyprexa	1
anti-smoking drug	zyban	1
anti-smoking treatment	zyban	1
option	zyrtec	1
belarus's opposition leader	zyanon paznyak	1
big cross-platform app maker	zynga	1
big social networking game developer	zynga	1
biggest social game studio	zynga	1
bleach resistant stage	zygote	1
bovine-based collagen product	zyplast	1
Buproprion hydrochlorides	zylon	1
cari zalloni form	zyklon	1
cd reissue	zyx	1
competitor polyamides	zytel htn by dupont	1
complex high end system	zytek	1
concentrated zymol product	zymol glas	1
consumer side company	zynga	1
contrast TLR2 ligands	zymosan	1
counter anti-histamines	zyrtec	1
cross-linked collagen	zyplast	1
CRP interacting protein	zyxin	1
group	zynga	2
embryo various term	zygote	1
ethnic and regional genre	zydeco	1
expression muscle	zygomaticus major	1
famous monograph	zygmund's trigonometric series	1
gaming developer	zynga	1
gaming IPOs	zynga	1
giant taiwanese OEM company	zyxel	1
good anti-microbial agent	zyklon-b	1
Hot gaming startups	zynga	1
independent social gaming firm	zynga	1
injectable human-derived product	zydermand zyplast	1
intel's own reference design	zylonite	1
key social game developer	zynga	1
lilly drug	zyprexa	1
lophidsdonot exhibitmammutid trait	zygodont	1
mechanical microkeratome	zyoptix xp	1
Modern wheat cultivars	zyta from poland	1
modern-day drug	zyban	2
molded synthetic plastic	zytel	1
nano-construction method	zyvex's atomically precise manufacturing	1
nicotine free drug	zyban	1
nicotine pill	zyban	1
non-aspergillus filamentous fungus	zygomycetes	1
Non-drowsy antihistimines	zyrtec	1
non-sedating meds	zyrtec	1
method	zymography	2
method	zygote scoring system	1
method	zygote intrafallopian transfer	1
nutrition counseling	zyto technology	1
offensive medication	zyprexa	1
online gaming competitor	zynga	1
ordinary health aide	zymox for ear	1
osmotolerant starter yeast	zygosaccharomyces rouxii	1
OTC allergy medicine	zyrtec	1
over-the-counter allergy tablet	zyrtec	1
pharmaceutical drug liability case	zyprexa	1
plant digestive enzyme	zymase	1
postmodern social theorist	zygmunt bauman	1
prescription anti-histamine	zyrtec	1
prescription quit-smoking aid	zyban	1
prokaryotic ethanologen	zymomonas	1
quit smoking drug	zyban	1
real life gaming	zynga farmville facebook	1
resistant stage	zygote	1
richard's friend	zygmunt	1
rival prescription drug	zyrtec	1
rx-to-otc switch product	zyrtec	1
method	zymogram pattern	1
serrated peeler	zyliss soft skin peeler	1
simple charophytic alga	zygnematales	1
slave trading organization	zygerrian slavers guild	1
social game company	zynga	1
social game developer	zynga	1
social gamin g offer	zynga poker	1
social gaming offer	zynga poker	3
somaliland important natural tree	zyziphus mauritiana	1
stadium extortionist	zygi wilf	1
stock prescription medication	zyban	1
thermo resin	zytel	1
TLR2 ligand	zymosan	1
tube route try allergy meds	zyrtec	1
viral game developer	zynga	1
voip router	zyxel's prestige  two thousand six hundred and two hw 	1
well-funded Internet start-ups	zynga	1
well-known facebook player	zynga	1
world class distributor	zycko	1
Zytel ST series	zytel st eight hundred and one 	1
factor	zygosity	1
product	zyban	4
product	zyrtec	4
project	zyon	1
artist	zyon y lennox	1
material	zytel	2
material	zylon	1
player	zydrunas ilgauskas	4
player	zynga	2
player	zydrunas ilgouskas	1
player	zydus cadila	1
technology	zydis	2
term	zygote	6
term	zygomycosis	1
parameter	zygote morphology	1
system	zymark alegro system	1
system	zymark's multidose g three 	1
species	zygia inequalis	2
species	zygosaccharomyces rouxii	2
species	zygophyllum coccineum	1
species	zygosaccharomyces cidri	1
condition	zyprexa	1
condition	zyrtec syrup once rare condition	1
product	zyplast	1
product	zydot ultra clean shampoo	1
brand	zywiec	3
site	zynga	3
site	zynga drawing valuations in the billion	1
