word	zzz	1
author	zz packer	1
person	zzzz best carpet cleaning scam	1
star	zz top	3
band	zz top	15
band	zzymzy quintet	1
plant	zz plant	3
celebrity	zz top	1
firm	zzzzz	1
act	zz top	2
act	zz topp	1
unit	zz gundam	1
musician	zz top	2
song	zz top's la grange''	1
variety	zz plant	1
big name	zz top	3
classic	zz top	2
influence	zz top	5
performer	zz top	3
luminary	zz hill	1
series	zz gundam	1
album	zz top's  early album	1
album	zz top's early album	1
famous artist	zz top	1
construction	zzzzzz	1
local band	zz top	1
CDs	zz top cds	1
great musician	zz top	1
search	zz top total earnings	1
rock band	zz top	2
recording	zz top recording	1
letter	zz	1
great act	zz top	1
recipient	zz packer	1
blue artist	zz top	1
foe	zzzax	1
world-renowned artist	zz top	1
crowd favorite	zz tops tush	2
music group	zz top	1
rock legend	zz top	1
big box store	zz sounds	1
suit	zz gundam	1
music band	zz top	1
famous maker	zz baby	1
texas artist	zz top	1
classic rock	zz top	1
texas musician	zz top	1
american act	zz top	1
wonder artist	zz top	1
action-packed game	zzt	1
stax record artist	zz hill	1
interesting place name	zzyzx rd	1
american landscape painter	zz wei	1
program	zzzz	1
multi-platinum act	zz top	1
double letter	zz	1
famous rock name	zz top	1
Gundam	zz gundam	1
jap bike	zzr s	1
powerful band	zz top	1
name	zz top	2
notable celebriteis	zz top's billy gibbons	1
parking lot favorite	zz top	1
single-combiner unit	zz gundam	1
Zzangs	zzang of the body	1
Zzangs	zzang of the face	1
ascii-based sandbox game	zzt	1
auditing horror story	zzzz best	1
custom system code	zz	1
group	zz top	7
gundam show	zz	2
high performance crate motor	zz four 	1
internally balanced engine	zz four 	1
low-maintenance, low-sunlight plant	zz plants	1
power level crate engine	zz four  chevy 	1
power rock	zz top	1
rough ground rod	zziplex tournament rod	1
SBC V8	zz four   three hundred and fifty-five hp from www.v eight archie.com 	1
method	zz	1
texas classic	zz top	1
artist	zz top	26
artist	zzt	3
artist	zz top's billy gibbons	1
